Abai	Oberlauf
Abas	Gewicht
Abat-jour	Fenster
Abb.	Abkürzung
Abendstern	Planet
Abendweite	Abstand
Aberglaube	Glaube
Abführmittel	Mittel
Ablation	Erniedrigung
Abrasion	Tätigkeit
Abruzzen	Hochland
Abschoß	Abgabe
Absorption	Eigenschaft
Abstimmung	Ermittlung
Abszeß	Ansammlung
Abtreiben	Prozeß
Abtrift	Winkel
Abûnâ	Titel
Abweichung	Abstand
Accompagnato	Bezeichnung
Achat	Gemenge
Ackerkulte	Verehrung
Act	Beschluß
Actium	Vorgebirge
Ad absurdum führen	Ungereimtheit
Adelboden	Seitental
Adelhozen	Weiler
Aderér	Bergland
Adiróndacks	Gebirgsgruppe
Aërenchym	Zellgewebe
Aërodynamik	Lehre
Aërogamen	Bezeichnung
Aëronaut	Lehre
Aërostatik	Lehre
Affiliation	Annahme
Affinieren	Ausscheidung
Affinität	Verwandtschaft
Affix	Mehrzahl
After	Öffnung
Afterfratt	Hautentzündung
Afterjucken	Folge
Afterskorpione	Ordnung
Afterspinnen	Ordnung
Ägeri	Wiesental
Agglutination	Vereinigung
Aggregat	Anhäufung
Agraffe	Spange
Agrikulturphysik	Physik
Agulhas	Südspitze
Ahaggar	Plateau
Ahnenverehrung	Verehrung
Aigrette	Büschel
Ailukinseln	Gruppe
Aizoazeen	Pflanzenfamilie
Akanthokephalen	Kratzer
Akariasis	Krankheit
Akklimatisation	Gewöhnung
Akkommodationsvermögen	Fähigkeit
Akline	Äquator
Akmolinsk	Gebiet
Akologie	Lehre
Aktinograph	Instrument
Aktinomykose	Infektionskrankheit
Aktinozoen	Gruppe
Aktionsradius	Strecke
Akústik	Lehre
Alagoas	Staat
Alaun	Doppelsalz
Albuminimeter	Instrument
Alembrothsalz	Doppelsalz
Alemdar	Titel
Aleuten	Kette
Alexipharmakon	Schutzmittel
Alexishafen	Hafen
Algebra	Lehre
Algodonalesbai	Bucht
Algónkin	Gruppe
Alizarin	Farbstoff
Alla breve	Bezeichnung
Allegorie	Personifikation
Allerkatholischste Majestät	Titel
Alliteration	Reimform
Alluvion	Vergrößerung
Almeh	Mehrzahl
Almuñécar	Seehafen
Alpákagewebe	Gewebe
Alraun	Wurzel
Altaisches Berggebiet	Distrikt
Altan	Platz
Altchristliche Kunst	Kunst
Altengrabow	Truppenübungsplatz
Alternat	Wechsel
Alterssichtigkeit	Zustand
Alte Welt	Afrika
Aluminiumsilber	Legierung
Alveolar	Alveole
Amalgam	Legierung
Amarantazeen	Pflanzenfamilie
Amaryllidazeen	Pflanzenfamilie
Amat	Gewicht
Amboëlla	Stamm
Amboß	Werkzeug
Ambriz	Reede
Ametrie	Mangel
Amnam	Gewicht
Amórph	Gegensatz
Ampère	Einheit
Ampèresche Regel	Regel
Amrît	Ruinenstätte
Amtsanwalt	Vertreter
Amulétt	Pergament
Amúr	Strom
Amusie	Mangel
Anabiose	Erscheinung
Anachoreteninseln	Gruppe
Anakoluth(on)	Mangel
Analekten	Sammlung
Analytik	Wissenschaft
Anam	Reich
Ananasöl	Lösung
Anaphrodisie	Mangel
Anarchie	Zustand
Anatomie	Lehre
Andechs	Weiler
Andes	Territorium
Anegenge	Titel
Angel	Gerät
Angioneurose	Erkrankung
Angolaerbsen	Samen
Angosturarinde	Rinde
Angra Pequena	Hafenplatz
Aniche(s)	Industriedorf
Animismus	Natur
Aniridie	Fehlen
Ankogelalpen	Gruppe
Anomalie	Abweichung
Anosmie	Unvermögen
Anrüchigkeit	Zustand
Anstiftung	Bestimmung
Antaphrodisiaka	Mittel
Antarktisch	Gegensatz
Anthere	Staubbeutel
Anthraknose	Krankheit
Anthrakometer	Instrument
Anthropogenie	Lehre
Anthropometrie	Lehre
Anthropozoische Formation	Bezeichnung
Antikritik	Erwiderung
Antimachiavéll	Titel
Antinomer	Anhänger
Antinomie	Widerspruch
Antinonnin	Paste
Antinosin	Natriumsalz
Antiperistáltisch	Bewegung
Antrieb	Produkt
Antwerk	Gesamtheit
Anwalt	Vertreter
Anweisung	Auftrag
a.o.	Abkürzung
Aphakie	Fehlen
Aphasie	Unvermögen
Aphrodisiaka	Mittel
Apokalýptik	Zweig
Apokópe	Weglassung
Apophthégma	Mehrzahl
Apostasie	Abfall
Apostelbrüder	Namen
a posteriori	Gegensatz
Apostolische Konstitutionen und Kanones	Sammlung
Apothezien	Fruchtkörper
Apozynazeen	Pflanzenfamilie
Appartement	Reihe
Appellabel	Berufung
Appellieren	Berufung
Appéndix	Mehrzahl
Appendizitis	Entzündung
Appenzell	Kanton
Apperzeption	Aufnahme
Applikationsarbeit	Verzierung
Appórt	Befehl
Aquavit	Abkürzung
Aquileja	Ortschaft
Äquilibrismus	Lehre
Äquität	Gleichheit
Ar	Flächenmaß
Ära	Mehrzahl
Arabismus	Eigentümlichkeit
Arachnitis	Entzündung
Aragua	Bundesstaat
Araliazeen	Pflanzenfamilie
Arbitrage	Tätigkeit
arc.	Abkürzung
Archangelsk	Gouvernement
Archäologie	Erforschung
Architektonik	Wissenschaft
Architekturmalerei	Zweig
Archiv	Sammlung
Archónt	Mehrzahl
Arco	Abkürzung
Ares	Verkörperung
Aretinische Silben	Benennung
Argentin	Flüssigkeit
Argo	Schiff
Arizona	Territorium
Armflosser	Familie
Armfüßer	Klasse
Arnheim	Bezeichnung
Arrowroot	Stärkemehl
Ars	Titel
Arsenal	Gebäude
Arsenikvergiftung	Folge
Arsenkupfer	Bezeichnung
Artá	Ortschaft
Artal	Gewicht
Ascus	Mehrzahl
Aspermatismus	Fehlen
Asphaltkopierverfahren	Asphalt
Asse	Höhenzug
Assemblée	Gesellschaft
Ästhesiometer	Instrument
Astrachan	Gouvernement
Astrognosie	Kenntnis
Astrolatrie	Verehrung
Astrometrie	Lehre
Astronomischer Ort	Punkt
Astrophotographie	Anwendung
Astrophysik	Zweig
Asymmetrie	Mangel
A.T.	Abkürzung
A.T.	Abkürzung
Ataïr	Stern
Atchin	Reich
Äthan	Kohlenwasserstoff
Ätiologie	Lehre
Atmosphärologie	Lehre
Atomístik	Anhänger
Atonie	Mangel
Atout	Trumpf
Atrophie	Verminderung
Attacca	Bezeichnung
Attentat	Versuch
Attenuieren	Verdünnung
Attisch	Feinheit
Attitüde	Haltung
Ätzlauge	Lösung
Auerbachs Keller	Weinkeller
Auersberg	Gipfel
Aufbereitung	Trennung
Aufbringen	Farbe
Auftakt	Anfang
Augenseuche	Augenkrankheit
Aulis	Sammelplatz
Aurês	Gebirgsstock
Ausfuhr	Absatz
Aushebung	Auswahl
Auspeilen	Tiefe
Auspex	Mehrzahl
Ausschalter	Vorrichtung
Ausschneidekunst	Kunst
Ausschwitzung	Durchdringen
Auszehrung	Abnahme
Auszug	Inbegriff
Authentizität	Echtheit
Autohypnose	Vermögen
Autointoxikation	Vergiftung
Autonomie	Recht
Autorisation	Erteilung
Autos	Mehrzahl
Autos de Fé	Mehrzahl
avdp.	Abkürzung
Avena	Hafer
Avérsum	Summe
Axonometrie	Messung
Azerazeen	Pflanzenfamilie
Azetonämie	Anhäufung
Azidimetrie	Bestimmung
Azidität	Wesen
Azimut	Bogen
Babarinseln	Gruppe
Bab el-Mandeb	Meerenge
Babismus	Glaubenssystem
Babuyaninseln	Gruppe
Babylonisches Exil	Aufenthalt
Bacenis	Waldgebirge
Backpulver	Mischung
Badachschan	Alpenland
Bagasse	Stengel
Bagdette	Rasse
Bagger	Vorrichtung
Bahar	Gewicht
Bähung	Anwendung
Baja California	Territorium
Bakonyer Wald	Waldgebirge
Bakteriologie	Lehre
Bakterioskopie	Untersuchung
Balaghat	Distrikt
Balchán	Gebirgsgruppe
Baldo	Bergzug
Balenit	Gemisch
Balkenrecht	Recht
Ballen	Zählmaß
Ballístik	Lehre
Ballistisches Pendel	Pendel
Ballotade	Sprung
Balneographie	Lehre
Bambunüsse	Samen
Bandwürmer	Ordnung
Bankétt	Erhöhung
Banzai	Aussprache
Baphomet	Symbol
Barawa	Hafenplatz
Bardale	Titel
Bären	Familie
Bärenlauch	Pflanze
Barranquilla	Flußhafen
Barre	Gewicht
Barrister	Titel
Barthel	Abkürzung
Bärtierchen	Ordnung
Bartvögel	Familie
Bärzeit	Brunst
Basch-Kadun	Titel
Basel	Kanton
Basis	Grundlage
Basizität	Eigenschaft
Bassadewitz	Kartenspiel
Bassari	Station
Bassigny	Umgebung
Baßklausel	Führung
Basuto	Stamm
Bath	Hohlmaß
Battikdruck	Gewebe
Batture	Untergrund
Baumannshöhle	Tropfsteinhöhle
Baumes-Chaudes	Tropfsteinhöhle
Baumkultus	Verehrung
Bäuschel	Rogen
Baycuruwurzel	Wurzel
B C	Abkürzung
Bco.	Abkürzung
Bé.	Abkürzung
Becher	Gipfel
Beckenmesser	Instrument
Bedford	Distrikt
Bedingte Verurteilung	Befugnis
Bed-Pak-Dala	Landstrich
Befestigungskunst	Kunst
Befruchtung	Anregung
Begoniazeen	Pflanzenfamilie
Beisitz	Recht
Belchen	Gipfel
Belial	Teufel
Bellonion	Militärmusik
Belloqsche Röhre	Instrument
Belmontylöl	Lösung
Bel zu Babel	Titel
Berberideen	Pflanzenfamilie
Berchtesgadener Hoher Thron	Gipfel
Bergamasca	Bergland
Bergblau	Farbstoff
Bergrecht	Inbegriff
Bergwage	Instrument
Bergwerkseigentum	Befugnis
Berichtigungspflicht	Pflicht
Bermudez	Staat
Bern	Kanton
Berner Disputation	Religionsgespräch
Berner Oberland	Gebiet
Bernina	Gebirgsstock
Bernsteinfirnis	Lösung
Berthe	Besatz
Berufsgenossenschaft	Vereinigung
Beschneidung	Sitte
Bescholtenheit	Zustand
Beschwerung	Erhöhung
Besikabai	Bucht
Besitz	Herrschaft
Beskiden	Grenze
Bessarabien	Gouvernement
Besteck	Tasche
Bethel	Anstalt
Beton	Mischung
Betonnung	Bezeichnung
Beutelratte	Gattung
Beuvray	Gipfel
Bevölkerungspolitik	Lehre
Bevölkerungsstatistik	Sammlung
Bewegung	Ortsveränderung
Bewegungsgröße	Produkt
BGB.	Abkürzung
Bhot	Zweig
Biarritz	Fischerhafen
Biberfluß	Oberlauf
Bibliothekswissenschaft	Inbegriff
Biblische Einleitung	Zweig
Bielshöhle	Tropfsteinhöhle
Bienenzucht	Zucht
Bierdruckapparat	Vorrichtung
Biewitz	Varietät
Bignoniazeen	Pflanzenfamilie
Bilánz	Abschluß
Bilche	Familie
Bildgießerei	Zweig
Bildnerei	Kunst
Bildnerei	Wachs
Bildschnitzerei	Gattung
Bilwis	Dämon
Binnenwanderungen	Bevölkerungsbewegung
Bioarithmetik	Berechnung
Biochemie	Lehre
Biodynamik	Lehre
Biogeographie	Lehre
Biologie	Lehre
Bionomie	Lehre
Biophänomenologie	Lehre
Bioskopie	Untersuchung
Biostatik	Lehre
Bischofinseln	Gruppe
Bismutol	Phosphorsäure
Bistritz-Naszód	Komitat
Bistum	Sprengel
Bittermandelöl	Zersetzungsprodukt
Bitterspat	Bezeichnung
Bitumen	Bezeichnung
Biwak	Lager
Bktz.	Abkürzung
Black Hills	Gebirgskette
Blanchebai	Bucht
Blanc-manger	Speise
Blanco	Vorgebirge
Bläschenausschlag	Bildung
Blasenfüße	Unterordnung
Blattflöhe	Familie
Blattfüßer	Ordnung
Blattläuse	Familie
Bläuling	Flügel
Bleichen	Zerstörung
Bleivergiftung	Folge
Blepharitis	Entzündung
Blindboden	Belag
Blinder Fleck	Eintrittsstelle
Blindheit	Fehlen
Bliny	Pfannkuchen
Blitzableiter	Vorrichtung
Blitzgefahr	Gefährdung
Blockade	Absperrung
Blödsinn	Schwäche
Blue Ridge	Bergkette
Blumea	Asien
Blumenkohl	Varietät
Blumenmalerei	Zweig
Blumensprache	Kunst
Blümlisalp	Bergstock
Blütenbiologie	Zweig
Blütenstand	Vereinigung
Blutharnen	Abgang
Blutschwär	Entzündung
Blutsenkung	Ansammlung
Bobine	Spule
Bock	Gestell
Bodendruck	Druck
Bodenmüdigkeit	Erscheinung
Bogdo-ola	Massiv
Bohême	Böhmen
Bohne	Hülsenfrucht
Bohrer	Werkzeug
Bohrmuscheln	Familie
Bojadór	Vorgebirge
Bolanpaß	Gebirgspaß
Bolivar	Geldeinheit
Bolivar	Staat
Boliviano	Geldeinheit
Bollandisten	Gesellschaft
Bollenz	Bezirk
Boma	Hafen
Bomarsund	Meerenge
Bombaystahl	Stahl
Bon	Spitze
Bonbonnière	Behältnis
Bone	Staat
Boni	Stamm
Bonitierung	Abschätzung
Bonzen	China
Boragineen	Pflanzenfamilie
Borinage	Landstrich
Borstenfäule	Erscheinung
Borstickstoff	Verbindung
Boss-puzzle	Geduldsspiel
Botanik	Wissenschaft
Bothkamp	Gutsbezirk
Boulogner Holz	Gehölz
Bowlinggreen	Rasenplatz
Brachygraphie	Schreiben
Brachypodium	Gattung
Brahmaputra	Strom
Brake	Vorrichtung
Braugerechtigkeit	Befugnis
Braunes Pulver	Schießpulver
Braunit	Manganoxyd
Brausemagnesia	Gemisch
Bråvallaheide	Platz
Bravi	Mehrzahl
Bravieren	Trotz
Brazzaville	Station
Brechmittel	Erbrechen
Bredasdorp	Distrikt
Breite	Winkel
Breithorn	Gipfel
Breitkolonne	Aufstellung
Breitseite	Bezeichnung
Bremer Beiträge	Bezeichnung
Bremse	Vorrichtung
Brennbüchl	Weiler
Brennerei	Darstellung
Breviloquénz	Kürze
Bridgewaterkanal	Kanal
Briefporto	Gebühr
Briel	Felsental
Brisingamen	Halsschmuck
Bristenstock	Gipfel
Bristolbai	Bucht
Bristolkanal	Bucht
Bromeliazeen	Pflanzenfamilie
Brömsebro	Brücke
Bronzedruck	Druck
Bronzetinktur	Flüssigkeit
Bronzezeit	Zeitraum
Brosimum	Milchsaft
Brotkorbgesetz	Bezeichnung
Bruchgraben	Verbindungskanal
Brumataleim	Terpentin
Brünig	Gebirgspaß
Brustseuche	Infektionskrankheit
Brusttee	Mischung
Brustwassersucht	Ansammlung
Brüten	Erwärmung
Bryazeen	Familie
Bryologie	Lehre
Btto	Abkürzung
Buch	Zählmaß
Buchdruckerkunst	Kunst
Buckelzirpen	Familie
Büfett	Schrank
Büffelseuche	Rinderseuche
Buglahmheit	Bewegungsstörung
Bukejewsche Horde	Zweig
Bulbus	Augapfel
Bulgarische Sprache	Zweig
Bulla	Sammlung
Bullition	Sieden
Bundasprache	Sprache
Buntblätterigkeit	Eigentümlichkeit
Burán	Innerasien
Bürgerrecht	Inbegriff
Burgund	Kanal
Burnettisieren	Verfahren
Bursfelde	Domäne
Bürste	Konstruktionsteil
Buschmannsland	Hochplateau
Bussarde	Unterfamilie
Büste	Abbild
Butyrometer	Instrument
Byron	Ostspitze
Byssazeen	Familie
c.a.	Abkürzung
Cadran	Zifferblatt
Cadre	Mehrzahl
Cahiz	Mehrzahl
Caïncawurzel	Wurzel
Cairngorm	Gruppe
Calvados	Departement
Calvinismus	Lehre
Camden	Hafen
Campagna di Roma	Landstrich
Campeche	Staat
Campus Martius	Platz
Canada	Dominion
Canal du Midi	Schiffahrtskanal
Cancionero	Sammlung
Cand.	Abkürzung
Canto	Gesang
Caorle	Fischerhafen
Capella	Stern
Capita	Mehrzahl
Capodistria	Hafen
Captatio benevolentiae	Bemühen
Carabobo	Staat
Carne pura	Präparat
Casar	Titel
Cash	Gewicht
Casiquiare	Strom
Cassinische Linie	Kurve
Castizo	Abkömmling
Catalpa	China
Catskillberge	Gruppe
Cauda	Nerven
Cavaliere	Titel
Caymansinseln	Gruppe
C.B.	Mitglied
c.d.	Abkürzung
Ceará	Staat
Cembratal	Stufe
Cenoman	Stufe
Cerebellum	Gehirn
Cerro Gordo	Gebirgspaß
Cestius	Pyramide
Cevedale	Gipfel
Cevennen	Südostrand
Chagres	Hafenplatz
Chan	Gebäude
Chan	Titel
Chan-tengri	Gipfel
Charkow	Gouvernement
Chasidim	Anhänger
Chasseral	Gipfel
Chasseron	Gipfel
Cheirotonie	Abstimmung
Chelmós	Gebirgsstock
Chemische Technologie	Anwendung
Chemische Zeichen	Zeichen
Chenopodiazeen	Pflanzenfamilie
Cherson	Gouvernement
Cherub	Mehrzahl
Ches	Abkürzung
Chevalier	Titel
Cheviot Hills	Bergzug
Chihuáhua	Staat
Chimborasso	Gipfel
Chinde	Hafen
Chinesische Sprache, Schrift und Literatur	Schrift
Chingan	Gebirgskette
Chinopyrin	Mischung
Chiragra	Gicht
Chiroplást	Instrument
Chlorophyzeen	Gruppe
Choleriker	Energie
Chopine	Schoppen
Chorditis	Entzündung
Chorioïdea	Aderhaut
Chr.	Abkürzung
Chrestomathie	Sammlung
Chrisma	Salböl
Christlische Archäologie	Darstellung
Christologie	Lehre
Chromatische Anpassung	Erscheinung
Chromatrop	Vorrichtung
Chronique scandaleuse	Titel
Chronologie	Lehre
Chronologisch	Zeitfolge
Chrysarobin	Bestandteil
Chrysobalanus	Fleisch
Chrysographie	Kunst
Churfirsten	Bergkette
Chymosin	Ferment
Chymus	Speisebrei
Cicer	Hülse
Cie.	Abkürzung
Cif	Abkürzung
Circeo	Vorgebirge
Cirren	Mehrzahl
Cirrhose	Verhärtung
Clariden	Bergstock
Clee Hills	Höhenzug
Clematis	Gattung
Cleveland	Hügelland
Clewbai	Bucht
Clos-Vougeot	Weinberg
Cn.	Abkürzung
c/o	Abkürzung
Co.	Abkürzung
Coahuila	Staat
Cobido	Längenmaß
Coecum	Blinddarm
Codex	Mehrzahl
Codices	Mehrzahl
Col.	Abkürzung
Cola	Abkürzung
Colima	Staat
Collomia	Nordamerika
Collon	Bergstock
Colorado	Staat
Columbia	Bundesdistrikt
Comes	Mehrzahl
Commern	Bürgermeisterei
Commilito	Mehrzahl
Concursus	Zusammenwirken
Condé	Seitenlinie
Condurango	Syphilis
Conf.	Abkürzung
Consecutio	Lehre
Contradictio	Widerspruch
Convoi	Bedeckung
Coopers Gold	Legierung
Coopers Spiegelmetall	Legierung
Corbières	Gebirgsgruppe
Cornea	Hornhaut
Corner	Vereinigung
Corpora	Mehrzahl
Corpus catholicorum	Bezeichnung
Corral	Hafen
cos	Abkürzung
Coß	Regel
Côte-d'Or	Hügelkette
Côte-Rôtie	Höhenzug
Cötus	Gesamtheit
Coudée	Längenmaß
Coulage	Verlust
Councillor	Mitglied
Couvade	Sitte
cr.	Abkürzung
Crau	Landstrich
Credit	Haben
C. R. M.	Abkürzung
Crocin	Farbstoff
Cro-Magnon	Höhle
Crooked Islands	Gruppe
Crt.	Abkürzung
Ct.	Abkürzung
Cuticula	Schicht
Cwt.	Abkürzung
Cyanometer	Instrument
Cyperazeen	Pflanzenfamilie
Cystitis	Entzündung
Dach	Bedeckung
Dachrecht	Recht
Dahlem	Domäne
Daidalos	Vertreter
Daktyliothek	Sammlung
Daktylologie	Kunst
Daleminzen	Stamm
Damm	Gegend
Dämmerung	Helligkeit
Dämmerungsfalter	Gruppe
Damnifizieren	Schaden
Dampf	Zustand
Dampfbodenkultur	Bearbeitung
Dämpfer	Vorrichtung
Dardschiling	Distrikt
Darmsaft	Sekret
Darwinismus	Theorie
Dasymeter	Instrument
Datiskazeen	Pflanzenfamilie
Davos	Hochtal
Dazio Grande	Weiler
D. D. D.	Abkürzung
Debatte	Aufeinanderfolge
Débouché	Ausgang
Decher	Zählmaß
Definition	Abgrenzung
Defizit	Betrag
Degagement	Befreiung
Degommieren	Hülle
Dégras	Emulsion
Dehna	Sandwüste
Dehnbarkeit	Eigenschaft
Deister	Waldgebirge
Dekagon	Figur
Dekan	Hochland
Dekapieren	Oberfläche
Dekastylon	Bauwerk
Dekhan	Hochland
Deklinationskreis	Meridian
Del.	Abkürzung
Demen	Mehrzahl
Demologie	Lehre
Demos	Mehrheit
Denaturieren	Natur
Dénouement	Lösung
Deosai	Hochland
Depekoration	Abnahme
Deplacement	Volumen
De profundis	Anfang
Derwisch	Bezeichnung
Desertion	Entfernung
Deshnew	Semen
Desmographie	Lehre
Desmopathie	Krankheit
Desorganisation	Zerstörung
Detention	Gewalt
Deuterokanonisch	Bezeichnung
Deutschenspiegel	Bearbeitung
Deutsche Philologie	Wissenschaft
Deutscher König	Bezeichnung
Deutsch-Lothringen	Bezeichnung
Deutschmeister	Vertreter
Deux-Sévres	Departement
Devalvation	Herabsetzung
Deviation	Abweichung
Dezembristen	Anhänger
Dezennium	Zeitraum
Dezentralisation	System
Dezimalsystem	Zahlensystem
Dezime	Stufe
Dharwar	Distrikt
Diablerets	Bergstock
Diagnose	Erkennen
Dialektologie	Lehre
Diamantstein	Baustein
Diamond Harbour	Seehafen
Diapénte	Quinte
Diaphragma	Entzündung
Dichroïsmus	Eigenschaft
Dichte	Masse
Dickhäuter	Gruppe
Dicksonhafen	Hafen
Dicta	Mehrzahl
Diëlektrische Körper	Nichtleiter
Diffamation	Verbreitung
Difficile est, satiram non scribere	Ausspruch
Dignánd	Basis
Diktyitis	Entzündung
Dilleniazeen	Pflanzenfamilie
Dim.	Abkürzung
Dimethylanilin	Salzsäure
Dióptrik	Lehre
Dioskoreazeen	Pflanzenfamilie
Dipl. Ing.	Abkürzung
Diplomatie	Inbegriff
Dipsodisch	Durst
Dipterokarpazeen	Pflanzenfamilie
Dipterologie	Lehre
Direktorium	Leitung
Disagio	Gegenteil
Diskontinuität	Mangel
Diskontrechnung	Berechnung
Diskredit	Mangel
Diskus	Anschwellung
Dispache	Berechnung
Dissogonie	Erscheinung
Distrito federal	Bundesdistrikt
Diuretin	Verbindung
Divination	Ahnung
Djoeatin	Mittel
dm	Abkürzung
Dnjestr	Strom
do.	Abkürzung
Döbel	Fisch
Doboka	Komitat
Dodekándrisch	Blüte
Doge	Titel
Dogmatik	Darstellung
Dogmatiker	Vertreter
Dol.	Abkürzung
Dôle	Gipfel
Dolja	Mehrzahl
Doljiu	Kreis
Dollar	Geldeinheit
Dolor	Mehrzahl
Domesnäs	Spitze
Domesnäs	Vorgebirge
Domherr	Mitglied
Domino	Gesellschaftsspiel
Domkapitular	Mitglied
Don Ranudo	Bezeichnung
Donum	Mehrzahl
Doppelwährung	Ordnung
Doppelzünder	Vereinigung
Dörböt	Stamm
Dorfpoesie	Bezeichnung
Dornbusch	Nordspitze
Dortmund-Ems-Kanal	Schiffahrtskanal
Dos-à-dos	Rücken
Dossier	Sammlung
Dotation	Gewährung
Doversches Pulver	Gemisch
Downingstreet	Straße
Doxologie	Lobpreisung
Dr.	Abkürzung
Drachenfische	Familie
Drahem	Gewicht
Drahtlehre	Lehre
Dramaturgie	Lehre
Dr. D. S.	Abkürzung
Drehwüchsigkeit	Eigentümlichkeit
Dreibund	Deutschland
Dreiecksköpfe	Gattung
Dreikronenkrieg	Dänemark
Dreischlitz	Verzierung
Dreschen	Arbeit
Dr.-Ing.	Abkürzung
Drohung	Kundgebung
Droserazeen	Pflanzenfamilie
Druckblau	Handelsbezeichnung
Druckwerk	Vereinigung
Dscholiba	Oberlauf
Dualismus	Lehre
Dücker	Unterführung
Dünger	Ersatz
Dünnschnäbler	Gruppe
Duodenitis	Entzündung
Durandsches Mittel	Mischung
Durango	Bundesstaat
Durchsuchungsrecht	Recht
Durchzugsrecht	Recht
Dürnberg	Bergstock
Dwarslinie	Formation
Dwt.	Abkürzung
Dynameter	Instrument
Dynamologie	Lehre
Dynamometamorphismus	Gesamtheit
Dynamometer	Vorrichtung
Dyne	Krafteinheit
Dyspesie	Verdauungsbeschwerden
Dystrophie	Zustand
dz	Abkürzung
East River	Wasserstraße
Eaton Hall	Landsitz
Ebenbürtigkeit	Gleichheit
Ebon	Gruppe
Ebullioskop	Instrument
e. c.	Abkürzung
Ecarté	Kartenspiel
Echiniten	Familie
Echinus	Glied
Edelfische	Ordnung
Effloreszénz	Blütezeit
E. G.	Abkürzung
Égalité	Wahlspruch
Eglomisieren	Verzierung
Egrenieren	Samen
Ehebruch	Verletzung
Eheliches Güterrecht	Verhältnis
Ei	Zelle
Eichel	Frucht
Eichsfeld	Ausläufer
Eidechsen	Ordnung
Eidesbruch	Verletzung
Eierpflaumen	Familie
Eierstock	Organ
Einhufer	Gruppe
Einkammersystem	System
Einkommen	Gesamtheit
Einmachen	Verfahren
Einsteuer	System
Eis	Wasser
Eiweißharnen	Ausscheidung
Ekrasit	Sprengmittel
Ekthyma	Hautkrankheit
Ektopie	Lageveränderung
Elbrus	Gebirgsstock
Elburs	Gebirgskette
Elektrische Arbeit	Produkt
Elektrische Einheiten	Grundlage
Elektrische Entladung	Übergang
Elektrische Lampe	Lampe
Elektrisches Potential	Potential
Elektrochemie	Lehre
Elektrochemitypie	Verfahren
Elektrodiagnóstik	Anwendung
Elektrodynamik	Lehre
Elektromagnetische Lichttheorie	Annahme
Elektromagnetismus	Lehre
Elektrotechnik	Anwendung
Elmina	Hafenplatz
Elwend	Gebirgsstock
Embolie	Verstopfung
Embryogenie	Entwicklung
Embryologie	Lehre
Embryosack	Zelle
Emer.	Abkürzung
Eminénz	Prädikat
Empetrazeen	Pflanzenfamilie
Empetrum	Rausch
Emphysem	Ansammlung
Emporkirche	Bezeichnung
Emser Punktation	Übereinkunft
Ems-Jade-Kanal	Schiffahrtskanal
Enchâssure	Fassung
Encounterbai	Bucht
Enderbyland	Küstenstrich
Endermatische Methode	Einführung
Endokarditis	Entzündung
Energetik	Lehre
Engadin	Hochtal
Enkomiástik	Kunst
Enseli	Hafenplatz
Ensilage	Aufbewahrung
Entasis	Anschwellung
Enten	Familie
Entencholera	Infektionskrankheit
Entenvögel	Ordnung
Enterologie	Lehre
Enteropneusten	Gruppe
Enteroskopie	Untersuchung
Entomolog	Wissenschaft
Eolithen	Bezeichnung
Eozoische Formation	Bezeichnung
Epagoge	Beweis
Epakridazeen	Pflanzenfamilie
Epen	Mehrzahl
Epha	Hohlmaß
Ephiáltes	Grieche
Epidemie	Bezeichnung
Epiglóttis	Kehldeckel
Epithel	Schicht
Epitome	Auszug
Eponym	Namen
Eques	Mehrzahl
Equisetazeen	Pflanzenfamilie
Erbrecht	Inbegriff
Erbschleicherei	Bemühung
Erbverzicht	Verzicht
Erdteil	Weltteil
Erdtoffel	Kartoffel
Erdwanze	Gattung
Erg	Arbeitseinheit
Ergotin	Bestandteil
Ernährung	Gesamtheit
Erotematik	Kunst
Erotik	Lehre
Errare humanum est	Irren
Errata	Mehrzahl
Ersa	Stamm
Erymanthos	Achaia
Erythem	Hautkrankheit
Erzgebirge	Grenzgebirge
Erzherzog	Titel
Erziehungskapital	Gesamtheit
Esbjerg	Nordseehafen
Esdrelon	Ebene
Essig	Gemenge
Essigstich	Krankheit
Estompe	Wischer
Estrich	Fußboden
Etalon	Normalmaß
Eternitschiefer	Ersatz
Ethik	Zweig
Ethische Bewegung	Amerika
Ethologie	Sitte
Etui	Behältnis
Etymologie	Lehre
Eudiometer	Instrument
Eukain	Ersatzmittel
Eulen	Familie
Eulengebirge	Gebirgskette
Eulenpapageien	Familie
Euphorbiazeen	Pflanzenfamilie
Eure-et-Loir	Departement
Eurytania	Nomos
Evolutioníst	Anhänger
Evolutionstheorie	Annahme
Ewkâf	Mehrzahl
Exárch	Gebiet
Exárch	Titel
Ex cathedra Petri	Ausspruch
Excud.	Abkürzung
Exekutive	Staatsgewalt
Exemplifikation	Beweis
Exemtion	Befreiung
Exmatrikulation	Entfernung
Exmatrikulation	Abgang
Exmission	Entfernung
Exmoor Forest	Hochebene
Exodium	Ausgang
Exordium	Eingang
Expromission	Eintritt
Exstirpation	Entfernung
Eyresee	Salzsee
Ezion Geber	Ausgangspunkt
Faba	Bohne
Fabel	Gattung
Fabula	Fabel
Facta	Mehrzahl
Facultas	Berechtigung
Fadenwürmer	Ordnung
Fähre	Anlage
Fahrlässigkeit	Unterlassung
Fakîr	Bezeichnung
Faksimile	Nachbildung
Faktura	Rechnung
Falciu	Kreis
Falealili	Hafen
Fall	Bewegung
Fall	Mehrzahl
Falle	Eisen
Fälschung	Nachbildung
Faltboot	Fahrzeug
Familie	Gemeinschaft
Fangheuschrecken	Familie
Fangzähner	Familie
Fao	Hafenplatz
Farbenblindheit	Unvermögen
Farbensinn	Vermögen
Farbhölzer	Farbstoff
Farewell	Südspitze
Fasanen	Unterfamilie
Fasanvögel	Familie
Fassade	Ansicht
Fassion	Angabe
Fatum	Mehrzahl
Faulbaum	Bezeichnung
Faulbrüchigkeit	Eigenschaft
Faulbrut	Krankheit
Faule	Krankheit
Faulhorn	Gipfel
Faultiere	Familie
Fauna	Gesamtheit
Fazial	Gesicht
Fazit	Ergebnis
Fec.	Abkürzung
Fechtkunst	Fertigkeit
Federbusch	Schmuck
Federmotten	Familie
Feet	Mehrzahl
Fehlergrenze	Spielraum
Feigheit	Neigung
Feinprobe	Bestimmung
Feldheuschrecken	Familie
Feldhühner	Unterfamilie
Feldpost	Einrichtung
Felgen	Brachfeld
Femelschlagbetrieb	Unterart
Ferghaná	Gebiet
Ferleiten	Ortschaft
Ferméntintoxikation	Vergiftung
Fernwirkung	Wirkung
Fettembolie	Verstopfung
Feuchtblatt	Glied
Feuerhahn	Vorrichtung
Feuerlöschwesen	Gesamtheit
Feuillants	Zweig
Fichtelgebirge	Waldgebirge
Fieberkurve	Darstellung
Figur	Umriß
Figuration	Belebung
Fikh	Wissenschaft
Filanda	Anstalt
Filtrieren	Trennung
Filzkrankheit	Bildung
Finderrecht	Recht
Finken	Familie
Finken	Verbindung
Finknetz	Kasten
Finschhafen	Hafen
Finstermünz	Engpaß
Firmamént	Himmel
Firnewein	Farbe
Fischgrätenbau	Bauart
Fischsaurier	Ordnung
Fla.	Abkürzung
Fläming	Höhenrücken
Flaschenzug	Vereinigung
Fledermäuse	Ordnung
Fleischbeschau	Prüfung
Fletschhorn	Gipfel
Flexion	Fähigkeit
Fliegen	Unterordnung
Fliete	Instrument
Flos	Mehrzahl
Flotte	Gesamtheit
Flüela	Seitental
Flügelfell	Wucherung
Flügellose	Unterordnung
Fluid meat	Präparat
Fluoreszénz	Eigenschaft
Fluorkalium	Fluorwasserstoff
Flüssigkeitswärme	Wärmemenge
fm	Abkürzung
Fod	Längenmaß
Fomalhaut	Stern
Fonda	Gasthof
Foot	Mehrzahl
Forlo	Hälfte
Formaldehyd	Aldehyd
Formschneidekunst	Kunst
Formular	Weise
Forstwissenschaft	Lehre
Foyle	Strom
Fr.	Abkürzung
Fra	Abkürzung
Fracht	Ladung
Frais	Krampf
Franceville	Station
Fränkisches Recht	Recht
Frater	Mehrzahl
Frauenfrage	Gesamtheit
Frauenstimmrecht	Recht
Frc.	Abkürzung
Freibord	Abstand
Freiburg	Kanton
Freiersbach	Weiler
Freihafen	Hafen
Freis	Krampf
Freizügigkeit	Recht
Fremantle	Hafen
Fremdenrecht	Inbegriff
Freskomalerei	Kunst
Frischen	Verfahren
Frisch, fromm, froh, frei	Wahlspruch
Front	Vorderseite
Froschperspektive	Ansicht
Frs.	Abkürzung
Fruchtbarkeit	Bezeichnung
Fruchttauben	Familie
Fruchtzucker	Zuckerart
Frühgeburt	Geburt
Fukazeen	Gruppe
Fukoideen	Gruppe
Fumariazeen	Pflanzenfamilie
Fundsche	Einzahl
Fundus	Grund
Fungi	Mehrzahl
Funkenfänger	Vorrichtung
Furchenwale	Familie
Furore	Aufsehen
Fürstenbank	Bezeichnung
Fuscher Tal	Hochtal
Fußartillerie	Bezeichnung
Fußballspiel	Spiel
Fußpfund	Maßstab
Futa Toro	Landstrich
Futter	Nahrung
Fz.	Abkürzung
FZM.	Abkürzung
Gadmental	Hochtal
Gailenreuther Höhle	Höhle
Galaktocele	Geschwulst
Galaxias	Milchstraße
Gallerte	Knochen
Gallmücke	Gattung
Gallon	Einheit
Galmei	Bezeichnung
Galtscha	Zweig
Galvanisches Element	Verbindung
Galvanochirurgie	Anwendung
Galvanotropismus	Erscheinung
Gambia	Strom
Gambierinseln	Gruppe
Gambir	Extrakt
Gamskarkogel	Gipfel
Gangri	Gebirgskette
Garndynamometer	Instrument
Garnelen	Familie
Garniec	Mehrzahl
Garonne	Departement
Gartensalat	Bezeichnung
Gasautomat	Einrichtung
Gasdruckmesser	Vorrichtung
Gaskalk	Nebenprodukt
Gasometrie	Messung
Gastein	Hochtal
Gastroenterostomie	Anlegung
Gastronomie	Inbegriff
Gastroskopie	Untersuchung
Gastrostomie	Anlegung
Gath	Heimat
Gatt	Ausfluß
Gattine	Krankheit
Gattung	Inbegriff
Gaugamela	Ortschaft
Gaza	Schauplatz
G. B. & I.	Großbritannien
Gebiß	Summe
Gebrauchsmuster	Muster
Gebrech	Rüssel
Geburt	Vorgang
Geckonen	Familie
Gedankenlesen	Kunst
Geelvinkbai	Bucht
Gefälle	Höhenunterschied
Gefängniswesen	Einrichtung
Gefrieren	Übergang
Gefriersalz	Benennung
Gehirnentzündung	Entzündung
Gehre	Zusammentreffen
Geierfalken	Unterfamilie
Geißeltierchen	Klasse
Gekröse	Falte
Gelbes Fieber	Infektionskrankheit
Gemeine Figuren	Natur
Genera	Plural
Generaloberst	Titel
Generalsekretär	Titel
Generalvikar	Vertreter
Genetiv	Nebenform
Genitiv	Kasus
Gentes	Mehrzahl
Gentianazeen	Pflanzenfamilie
Geraniazeen	Pflanzenfamilie
Gerichtliche Medizin	Lehre
Gerichtliche Psychologie	Lehre
Gerichtsbarkeit	Befugnis
Gerlos	Hochtal
Gersch	Mehrzahl
Geruch	Fähigkeit
Geschäftsordnung	Inbegriff
Geschirr	Vorrichtung
Geschmacksmuster	Muster
Gesnerazeen	Pflanzenfamilie
Gesta	Titel
Geviert	Ebene
Gewächshäuser	Gebäude
Gewährsmängel	Fehler
Gewerbemuseum	Anstalt
Gewerberat	Titel
Gewerbliches Eigentum	Recht
Gewerkschaft	Vereinigung
Gewicht	Druck
Gewohnheitsrecht	Inbegriff
Ggw.	Abkürzung
Gicht	Krankheit
Gichtpapier	Terpentin
Gießerei	Verfahren
Giltstein	Varietät
Ginsengwurzel	Wurzel
Gipfeldürre	Krankheit
Girl	Rinne
Giro	Gewicht
Glanze	Klasse
Glanzvögel	Familie
Glariden	Bergstock
Glärnisch	Bergstock
Glarus	Kanton
Glasdruck	Kunst
Glaskunstindustrie	Schliff
Glasmalerei	Kunst
Glasschwämme	Ordnung
Glasurerz	Bleiglanz
Glattwale	Familie
Glauberit	Gemisch
Gleditschia	Afrika
Gleicheniazeen	Pflanzenfamilie
Gleichflügler	Unterordnung
Gleichung	Störung
Gliederfüßer	Kreis
Gliedertiere	Bezeichnung
Globetrotter	Bezeichnung
Globigerinen	Familie
Globuli	Mehrzahl
Globulus	Mehrzahl
Glockentierchen	Familie
Glossolalie	Erscheinung
Glühkörper	Körper
Glühwurm	Bezeichnung
Glyptik	Kunst
Glyptodon	Gattung
Gnadenzeit	Frist
Gnetazeen	Pflanzenfamilie
Göhrde	Laubwald
Goï	Mehrzahl
Goldamalgam	Verbindung
Goldene Horde	Heerlager
Goldene Mark	Umgebung
Goldfink	Bezeichnung
Goldkäfer	Bezeichnung
Goldspinnerei	Verfahren
Goldwespen	Familie
Gomaristen	Anhänger
Gonagra	Gicht
Gondokoro	Niederlassung
Goniometrie	Lehre
Gornergletscher	Eisstrom
Görtz	Schlitz
Gosau	Hochtal
Gotenburger Ausschanksystem	Einrichtung
Goethearchiv	Sammlung
Goethebund	Gruppe
Gotische Schrift	Schrift
Gotische Sprache	Zweig
Gott mit uns	Devise
Goyaz	Staat
Grabeau	Abfall
Grabeau	Bruch
Grabfüßer	Klasse
Gradiént	Richtung
Graditz	Domäne
Gradus ad Parnassum	Stufe
Gramineen	Pflanzenfamilie
Grammátik	Darstellung
Gran	Komitat
Grand Canal	Kanal
Grandes-Rousses	Massiv
Grandeza	Würde
Grand-Junction-Kanal	Kanal
Grand-Trunk-Kanal	Kanal
Grao de Castellón	Hafen
Graphologie	Kunst
Graphophon	Abart
Graphotypie	Verfahren
Graptolithen	Familie
Graubünden	Kanton
Gravüre	Erzeugnis
Gregarinen	Gruppe
Greifschwanzaffen	Unterfamilie
Greisen	Gemenge
Grenadinen	Gruppe
Grenzwache	Gesamtheit
Greyerz	Bezirk
Griechische Mythologie	Gesamtheit
Griffelschiefer	Abart
Grindelia	Kraut
Gris Nez	Vorgebirge
Grodno	Gouvernement
Gromatik	Kunst
Grönsund	Meeresstraße
Großflügler	Familie
Großherzog	Titel
Grubenottern	Familie
Grundbau	Lehre
Grundriß	Zeichnung
Gründüngung	Anbau
Grünten	Vorgipfel
Grusch	Mehrzahl
Guanajuato	Staat
Guaraná	Heilmittel
Guayaquil	Santiago
Guayas	Küstenprovinz
Guaymas	Hafen
Guerrero	Staat
Guinea	Küstenland
Guldborgsund	Meerenge
Gully	Mehrzahl
Gummiharze	Gemenge
Gummiwarenfabrikation	Bezeichnung
Gurage	Hochland
Gurusch	Mehrzahl
Gußformen	Vorrichtung
Gußgerechtigkeit	Recht
Gutenberger Höhle	Tropfsteinhöhle
Gütertrennung	System
Gynäkologie	Lehre
Gynándren	Ordnung
ha	Abkürzung
Haarbalgmilben	Familie
Haarseil	Schnur
Haarwürmer	Ordnung
Habichte	Unterfamilie
Hackenfuß	Mißbildung
Hackney	Distrikt
Hacksch	Schwein
Hadernkrankheit	Infektionskrankheit
Haftkiefer	Ordnung
Haftpflicht	Pflicht
Haggada	Mehrzahl
Hagiolatrie	Verehrung
Hagiotik	Lehre
Hainasches Gebirge	Vorsprung
Hainich	Höhenzug
Hainleite	Höhenzug
Hai-phong	Seehafen
Hakenkäfer	Familie
Halbblut	Produkt
Halbflügler	Ordnung
Halbkugel	Hälfte
Halbton	Sekunde
Halieutik	Kunst
Halochemie	Chemie
Halurgie	Lehre
Hamamelidazeen	Pflanzenfamilie
Hämatostatik	Lehre
Hamaxobier	Bezeichnung
Hammerschlagsrecht	Recht
Hämometer	Instrument
Hämopathologie	Lehre
Hämorrhophilie	Bluterkrankheit
Handelsarithmetik	Anwendung
Handelsdollar	Bezeichnung
Handelskorrespondenz	Briefwechsel
Handelsrecht	Gesamtheit
Handlohn	Abgabe
Hanfkrebs	Krankheit
Hänflinge	Gruppe
Hängebank	Mündung
Hangwage	Instrument
Harari	Sprache
Harfenschnecken	Familie
Harnkolik	Behinderung
Harnsäure-Infarkt	Verstopfung
Harntreibende Mittel	Mittel
Harnverhaltung	Aufhören
Háromszék	Komitat
Harra	Wüste
Harrah	Wüste
Harrasfelsen	Felsen
Härte	Widerstand
Hartschlächtigkeit	Krankheit
Haschee	Gericht
Hasenmäuse	Familie
Hasnadar Kadyn	Titel
Haßberge	Höhenzug
Hasta	Längenmaß
Hatzfeldthafen	Bucht
Hauran	Hochebene
Hausen	Fisch
Hausrecht	Recht
Haússastaaten	Gebiet
Hausstock	Gipfel
Hautemphysem	Ansammlung
Hautevolee	Gesellschaft
Hauttalg	Sekret
Hautwanzen	Familie
Hautwassersucht	Ansammlung
Havelländischer Hauptkanal	Kanal
Hawâsch	Strom
H. E.	Abkürzung
Hebräische Sprache	Zweig
Heck	Fläche
Hedonik	System
Hegyalja	Gebirgszug
Heilserum	Blutserum
Heißluftbäder	Anwendung
Heizung	Erwärmung
Heldenbuch	Titel
Heldensage	Kreis
Helikon	Gebirgszug
Helikoniden	Familie
Heliograph	Instrument
Heliographie	Lehre
Heliometer	Instrument
Helling	Ebene
Hemimorphie	Erscheinung
Henequen	Faser
Henriquinquisten	Anhänger
Heortologie	Lehre
Hepatalgie	Neuralgie
Heptameron	Titel
Herakleion	Nomos
Heráldik	Wissenschaft
Herbarium	Sammlung
Heronsball	Vorrichtung
Herrenmeister	Titel
Herrstein	Bürgermeisterei
Herzerweiterung	Ausdehnung
Herzhypertrophie	Vergrößerung
Herzogenstand	Gipfel
Herzschwäche	Insuffizienz
Hesperos	Abendstern
Hessisches Berg- und Hügelland	Gesamtheit
Heteromorphismus	Vorkommen
Heteronomie	Abhängigkeit
Heteropygii	Familie
Heuberg	Hochfläche
Heumar	Bürgermeisterei
Hexachórd	Folge
Hexaktinien	Ordnung
Hidalgo	Titel
H. I. H.	Abkürzung
Himbeerzunge	Aussehen
Himmelsphotographie	Abbildung
Hippocastanum	Roßkastanie
Hippomachie	Kampf
Hippus	Krampf
Hirschtalg	Heilmittel
Histogenese	Lehre
Histologie	Lehre
hl	Abkürzung
H. L.	Abkürzung
Hobel	Werkzeug
Hochätzkunst	Erzeugung
Hochbaukunde	Lehre
Hochdruck	Kunst
Hochehrwürden	Prädikat
Hochgeboren	Titel
Hochkönig	Gipfelpunkt
Hochofenschlacke	Schlacke
Hochverrat	Verletzung
Hochvogel	Gipfel
Hochwang	Gebirgszug
Hochwürden	Prädikat
Hofstaat	Gesamtheit
Hofsystem	Ansiedelung
Hoheit	Staatsgewalt
Hoheitszeichen	Zeichen
Hohe Mense	Gipfel
Höhendienst	Verehrung
Hohenheim	Staatsdomäne
Höhenrauch	Trübung
Hohenstein	Kreis
Hohenzollernhafen	Hafen
Hohe Pforte	Bezeichnung
Hohe Salve	Gipfel
Hohgant	Bergstock
Höhlenenten	Familie
Höhlenfauna	Gesamtheit
Hohlhörner	Familie
Hoi-hau	Hafen
Hokkovögel	Familie
Hokuspokus	Zauberformel
Holkar	Titel
Holländer Huhn	Rasse
Holyhead	Hafen
Holzgewebe	Gewebe
Holzin	Lösung
Holzkassie	Sammelname
Holzkitt	Zusammensetzung
Holzkohle	Haufen
Holzläuse	Familie
Holzmalerei	Verzierung
Holzschneidekunst	Kunst
Holzzement	Gemenge
Homöopathie	Leiden
Homo primigenius	Bezeichnung
Hon.	Abkürzung
Honorarprofessor	Titel
Höntrop	Bauerschaft
Hopi	Stamm
Horde	Bezeichnung
Hordeolum	Gerstenkorn
Hordeum	Gerste
Horn	Auswuchs
Hörnchen	Familie
Hornfessel	Riemen
Hornhautentzündung	Entzündung
Hornschwämme	Ordnung
Horribilicribrifax	Titel
HP	Abkürzung
H.R.H.	Abkürzung
Huascan	Gipfel
Huasteken	Zweig
Hub	Weiler
Hufpfötler	Familie
Hüfte	Gesamtheit
Hühnerbrust	Formveränderung
Hühnerlaus	Bezeichnung
Hühnervögel	Ordnung
Hülsenwurm	Finne
Human	Würde
Humanismus	Richtung
Hummelfliegen	Familie
Hümmling	Wasserscheide
Hunde	Familie
Hundsgrotte	Höhle
Hünengräber	Bezeichnung
Hungerwespen	Familie
Hunnenschlacht	Schlacht
Hussiten	Anhänger
Hustings	Rednerbühne
Huthaus	Gebäude
Hütte	Anlage
Hüttenkatze	Vergiftung
Hutungsrecht	Recht
Hwai-jang-Gebirge	Ostende
Hyalitis	Entzündung
Hýdor	Wasser
Hydránt	Vorrichtung
Hydrat	Verbindung
Hydrocele	Ansammlung
Hydrodynamischer Druck	Druck
Hydrophyllazeen	Pflanzenfamilie
Hydrosandstein	Mischung
Hydroskopie	Untersuchung
Hygiene	Lehre
Hygroskopizität	Eigenschaft
Hyle	Materie
Hymenium	Schicht
Hyperikazeen	Pflanzenfamilie
Hyperostose	Wucherung
Hypertrophie	Vergrößerung
Hypnotismus	Lehre
Hypoblást	Keimblatt
Hypomochlium	Stützpunkt
Hypothek	Recht
Iatrochemie	Zeitalter
Iatromathematik	Anwendung
Ibenhorst	Gutsbezirk
Iberia	Georgien
Ibi	Station
Ibisvögel	Familie
Icacopflaumen	Fleisch
Ich hab's gewagt	Wahlspruch
Ichtiad	Reserve
ICtus	Abkürzung
id.	Abkürzung
Ideal	Übereinstimmung
Ideenassoziation	Verbindung
Identität	Verhältnis
Idistavisus	Talebene
Igelhuf	Fußkrankheit
Ikosándrisch	Blüte
Ikterus	Gelbsucht
i.L.	Abkürzung
Ileum	Hälfte
Illiberal	Gegensatz
Illy	Plateau
Im Lichten	Weite
Immunität	Befreiung
Imp.	Abkürzung
Imperativ	Befehlsform
Imperatorskaja	Bucht
Impériale	Himmel
Impietät	Mangel
Imponieren	Achtung
Impressionismus	Richtung
I. N. D.	Abkürzung
Ind.	Abkürzung
Indeterminiert	Gegensatz
Indices	Mehrzahl
Indikator	Instrument
Induktion	Erregung
Induktion	Erregung
In dulci jubilo	Anfang
Induline	Gruppe
Indurit	Gemisch
Infallibel	Unfehlbarkeit
Infárkt	Verstopfung
Infernal	Unterwelt
Infinitesimalrechnung	Rechnung
Infléktor	Aufsatz
Influénz	Vorgang
Infusorien	Klasse
Infusum	Gerät
Ingrediens	Bestandteil
Inhampura	Unterlauf
Initia	Mehrzahl
Inkl.	Abkürzung
Innervation	Einfluß
Inosurie	Abart
Insalivation	Vermischung
Inspizieren	Musterung
Insubordination	Auflehnung
Intabulation	Eintragung
Intention	Richtung
Interésse	Anteil
Interieur	Innere
Intertrigo	Hautentzündung
Interzellularflüssigkeit	Flüssigkeit
Intrige	Gewebe
Intussuszeption	Aufnahme
Inv.	Abkürzung
Inventur	Aufnahme
Invertzucker	Gemenge
Investition	Anlage
Investitur	Einführung
Inzitaménte	Mittel
Inzucht	Vereinigung
Io.	Abkürzung
Ipekakuanha	Wurzel
Irâk	Landstrich
Iranische Sprachen	Familie
Iridazeen	Pflanzenfamilie
Isagoge	Einführung
Islamitische Kunst	Ausbreitung
Islay	Hafen
Istrandscha-dagh	Gebirgsland
It.	Abkürzung
Jabassi	Station
Jablunkagebirge	Gebirgszug
Jagara	Zucker
Jagd	Kunst
Jagdhoheit	Recht
Jagdrecht	Befugnis
Jagdzeug	Hilfsmittel
Jägersprache	Gesamtheit
Jahr	Zeitraum
Jahrhundert	Zeitraum
Jáila	Gebirgszug
Jakuten	Zweig
Jalon	Stange
Japanische Sprache	Schrift
Japanisches Wachs	Pflanzenfett
Jarosláwl	Gouvernement
Jassák	Abgabe
J.C.	Abkürzung
Jehol	Sommerresidenz
Jekaterinosláw	Gouvernement
Jenissei	Strom
Jesuitentee	Kraut
Jildis-Kjöschk	Residenz
Jingo	Bezeichnung
Johore	Staat
Jokkai	Hafen
Joko	Station
Joule	Einheit
Jouxtal	Hochtal
Juan-de-Fuca-Straße	Meerenge
Judentum	Inbegriff
Juglandazeen	Pflanzenfamilie
Juk	Summe
Jukon	Strom
Julische Alpen	Gruppe
jun.	Abkürzung
Junkazeen	Pflanzenfamilie
Jupiter	Planet
Jura	Mehrzahl
Juraalpen	Gruppe
Juror	Mitglied
Jus	Recht
Justemilieu	Mitte
Justitia regnorum fundaméntum	Gerechtigkeit
Justizhoheit	Inbegriff
Justizverwaltung	Tätigkeit
Juwel	Schmuck
Kaffa	Heimat
Kaffeesurrogate	Ersatzmittel
Kafiristan	Alpenland
Kalabar	Küstenstrich
Kalam	Gebirgsgegend
Kaledonischer Kanal	Kanal
Kaliber	Durchmesser
Kalieren	Segel
Kalif	Titel
Kalisch	Gouvernement
Kaliubieh	Südspitze
Kalk	Verbindung
Kalkschwämme	Ordnung
Kalobiotik	Kunst
Kalorie	Einheit
Kalorik	Lehre
Kaltwasserkur	Anwendung
Kalúga	Gouvernement
Kalykanthazeen	Pflanzenfamilie
Kalziumkarbid	Verbindung
Kamerunnuß	Erdnuß
Kamjanüsse	Samen
Kammbau	Anbau
Kämmen	Verfahren
Kammuscheln	Familie
Kampanulazeen	Pflanzenfamilie
Kämpe	Schwein
Kampfer	Produkt
Kan.	Abkürzung
Käna	Stamm
Kandel	Berggipfel
Kandis	Zucker
Kannabin	Alkaloid
Kannazeen	Pflanzenfamilie
Kanonenfutter	Ausdruck
Kanonizität	Inbegriff
Kans.	Abkürzung
Kantharidin	Bestandteil
Kántor	Titel
Kaoko	Gebiet
Kaolin	Produkt
Kapella	Gebirgszug
Kapellenprobe	Untersuchung
Kapitalisierung	Kapitalismus
Kapitular	Mitglied
Kapparidazeen	Pflanzenfamilie
Kappziegel	Dachziegel
Kapruner Tal	Seitental
Kapselstar	Trübung
Kapuziner	Zweig
Karbonat	Abart
Kardinal	Getränk
Karieren	Mangel
Karpfenlachse	Familie
Karru	Hochebene
Kars	Gebiet
Kartenbrief	Karton
Kartometrie	Lehre
Karvon	Bestandteil
Karwoche	Woche
Karyophyllazeen	Pflanzenfamilie
Kasán	Gouvernement
Kasanpaß	Engpaß
Kaschmir	Gewebe
Käsemilben	Familie
Kaserne	Gebäude
Kaska	Rinde
Kaskadengebirge	Gebirgszug
Kaskarilla	Rinde
Kassonade	Rohzucker
Kasuístik	Anwendung
Katak-Mehal	Sammelname
Katakolon	Hafen
Katalékten	Sammlung
Katárrh	Entzündung
Katatonie	Geisteskrankheit
Kategorie	Begriff
Kathetometer	Vorrichtung
Katholische Majestät	Titel
Katóptrik	Lehre
Katschar	Distrikt
Kätti	Mehrzahl
Katunjagebirge	Gebirgsstock
Katzen	Familie
Kauterisation	Anwendung
Kautionsversicherung	Gewährung
Kavaliere	Anhänger
Keelinginseln	Gruppe
Kees	Tirol
Kegelschnecken	Familie
Kehlfüßer	Unterordnung
Keilbein	Knochen
Keim	Grundlage
Kelat	Residenz
Kelchseite	Epistelseite
Kelgum	Präparat
Kelp	Asche
Kempen	Landstrich
Ken	Längenmaß
Kenia	Gebirgsstock
Kennel	Hundezwinger
Keratophyllazeen	Pflanzenfamilie
Keratoplástik	Bildung
Kerkyra	Nomos
Kernschußweite	Entfernung
Keßlerloch	Höhle
Ket	Glied
Ketah	Milchsaft
Kete	Summe
Kettenbaum	Walze
Kettenpumpe	Vorrichtung
Kettenrechnung	Verfahren
kg	Abkürzung
kgm	Abkürzung
Kiamari	Hafen
Kibo	Spitze
Kicher	Hülse
Kiefer	Knochen
Kieferklemme	Unfähigkeit
Kiellinie	Formation
Kiemenfüßer	Unterordnung
Kieselsäure	Verbindung
Kieselschwämme	Gruppe
Kiew	Gouvernement
Kilar	Proviant
Kilauea	Krater
Kilogramm	Einheit
Kilometer	Einheit
Kindergarten	Anstalt
Kindesmord	Tötung
Kinematik	Lehre
Kinetik	Lehre
Kinetische Gastheorie	Vorstellung
Kirchenbann	Ausschließung
Kirchenhoheitsrecht	Inbegriff
Kirchenrecht	Inbegriff
Kirchenverfassung	Organisation
Kirchenvisitation	Untersuchung
Kirchenzucht	Gesamtheit
Kirschäther	Lösung
Kisil-kum	Sandwüste
Kisuaheli	Sprache
Kithäron	Waldgebirge
Kjelzy	Gouvernement
K. K.	Abkürzung
Kladderadatsch	Titel
Klassifikation	Anordnung
Klauenträger	Klasse
Kleekrankheit	Krankheit
Kleiengrind	Hautkrankheit
Kleinhirn	Gehirn
Kleinzirpen	Familie
Kleistogamie	Bestäubung
Klek	Hafen
Klieven	Spalten
Kloben	Flasche
Klöppeln	Kunst
Kluppe	Werkzeug
Klusiazeen	Pflanzenfamilie
Klüver	Segel
Klüverbaum	Verlängerung
km	Abkürzung
Knallgas	Gemisch
Kni	Gelenk
Kniephänomen	Erscheinung
Knochenatrophie	Verkleinerung
Knochenhautentzündung	Entzündung
Knötchenschwindsucht	Tuberkulose
Knowledge is power	Wissen
Koalitionsrecht	Recht
Köcher	Behältnis
Kochkunst	Fertigkeit
Kochkunst	Speisen
Kodifikation	Sammlung
Koëxisténz	Vorhandensein
Kofferdamm	System
Kohle	Produkt
Kohleneisenstein	Gemenge
Kokain	Alkaloid
Köken	Untugend
Kokon	Schutzhülle
Kokospalme	Hülle
Kokospflaume	Fleisch
Kollatur	Recht
Kollegium	Gesamtheit
Kolli	Mehrzahl
Kólokol	Titel
Kolombowurzel	Wurzelstock
Kolonialrecht	Recht
Kolonialschule	Anstalt
Kolonialpulver	Sprengstoff
Kolorimeter	Instrument
Kólowratshöhle	Höhle
Kolpitis	Entzündung
Komma	Mehrzahl
Kommandement	Überhöhung
Kommando	Ausführung
Kommelinazeen	Pflanzenfamilie
Kommission	Auftrag
Kommissionshandel	Betreibung
Kommissur	Punkt
Kommunarden	Anhänger
Komödie	Gattung
Komorin	Südspitze
Komparator	Vorrichtung
Kompaß	Instrument
Kompeténz	Wirkungskreis
Kompeténz	Befugnis
Komplanation	Berechnung
Komplótt	Verbindung
Komposition	Vereinigung
Kompressionsmyelitis	Entzündung
Kondensation	Verdichtung
Kondottiere	Mehrzahl
Kongo	Handelsbezeichnung
Koniferin	Glykosid
Königsblau	Bezeichnung
Königswasser	Mischung
Konjunktur	Verbindung
Konkordienbuch	Sammlung
Konnivieren	Nachsicht
Konsekutiv	Folge
Konservator	Titel
Konstellation	Stellung
Konti	Mehrzahl
Konversation	Unterhaltung
Kopffüßer	Klasse
Kopfstation	Bahnhof
Koppen	Untugend
Kornazeen	Pflanzenfamilie
Kornutin	Alkaloid
Körperverletzung	Verletzung
Korymbiferen	Unterfamilie
Koryza	Schnupfen
Kosekánte	Verhältnis
Kosmische Meteorologie	Lehre
Kosmogonie	Lehre
Kostajnica	Komitat
Kostin-Schar	Meerenge
Kostromá	Gouvernement
Kotierung	Zulassung
Kottische Alpen	Kette
Kotzen	Stoff
Kow-loong	Hafen
Kowno	Gouvernement
Koyang	Gewicht
Králóva Hora	Berggipfel
Kranabitsattel	Gipfel
Krängen	Neigung
Krankenhaus	Gebäude
Krankheit	Störung
Krapplack	Niederschlag
Krassulazeen	Pflanzenfamilie
Kratzer	Ordnung
Kräuselkrankheit	Krankheit
Krebs	Krankheit
Krebstiere	Klasse
Kredénzen	Speisen
Kreisdirektor	Anhalt
Kren	Meerrettich
Kreuz	Bahnhof
Krieg	Kampf
Kriegsfeuerwerkerei	Lehre
Kriegsflegel	Abart
Kriegsgeschichte	Geschichte
Kriegsspiel	Ausführung
Kriminalanthropologie	Wissenschaft
Kriminalístik	Lehre
Kriminalpolitik	Lehre
Kriminalsoziologie	Untersuchung
Krith	Einheit
Krivoije	Karstlandschaft
Krondotation	Ausstattung
Kronland	Grund
Krontauben	Familie
Krönung	Einsetzung
Kröten	Familie
Krugrecht	Recht
Kruppe	Kreuz
Kryoskopie	Bestimmung
Kryptoskop	Instrument
K.S.	Abkürzung
Kt.	Abkürzung
Kubany	Berggipfel
Kubatur	Berechnung
Kubieren	Potenz
Kujawien	Landstrich
Kukúmer	Gurke
Kukurbitazeen	Pflanzenfamilie
Kulack	Gewicht
Kulíkowo Polje	Ebene
Kulinarisch	Kochkunst
Kultur	Anbau
Kulturkampf	Bezeichnung
Kulturtechnik	Lehre
Kumtgeschirr	Vorrichtung
Kumulus	Wolkenform
Kundschara	Stamm
Kun-san	Hafen
Kunstgeschichte	Darstellung
Kupferpecherz	Gemenge
Kupferstechkunst	Kunst
Kupuliferen	Pflanzenfamilie
Kürrecht	Recht
Kursk	Gouvernement
Kurvenmesser	Instrument
Küstengebiet	Küstenmeer
Küstengebiet	Gebiet
Küstengebirge	Küste
Kutaís	Gouvernement
Kutteln	Eingeweide
Ky.	Abkürzung
Kyllene	Gebirgsstock
Kymographion	Instrument
Kynologie	Lehre
Kyphose	Krümmung
Kyrenaiker	Anhänger
La.	Abkürzung
Labiaten	Pflanzenfamilie
Ladestock	Instrument
Ladezeit	Frist
Ladritscher Brücke	Brücke
Lafette	Gestell
Lagergeschäft	Übernahme
Lähme	Krankheit
Lais	Mehrzahl
Lakkadiven	Gruppe
Lakritze	Extrakt
Lalenbuch	Sammlung
Lalla Rookh	Dichtung
Lama	Titel
Lamarckismus	Theorie
Lambris	Bekleidung
Lamm Gottes	Benennung
Lançade	Sprung
Lancastersund	Straße
Landasseln	Familie
Landesrat	Titel
Landgraf	Titel
Landwanzen	Gruppe
Länge	Winkel
Langflügler	Ordnung
Langwanzen	Familie
Lanoform	Salbe
Lan-tsan	Teilnahme
Lapérousestraße	Meerenge
Lappa	Hafen
Lappenquallen	Ordnung
La recherche de la paternité est interdite	Erforschung
Laschid	Nomos
Laschkar	Feldlager
Lasgori	Hafen
Lasithi	Nomos
Lassithi	Nomos
Lastigkeit	Tragfähigkeit
Lasurstein	Gemenge
Lateinische Sprache	Sprache
Laubfrösche	Familie
Laubheuschrecken	Familie
Laubhölzer	Sammelname
Laubkäfer	Geschlecht
Laubvögel	Familie
Läufigkeit	Brunft
Laufmilben	Familie
Laufvögel	Ordnung
Läusekrankheit	Ansammlung
Lazzaroni	Bezeichnung
lb	Abkürzung
L.C.	Abkürzung
Leben	Inbegriff
Lebensfähigkeit	Fähigkeit
Leberegelseuche	Krankheit
Lebombogebirge	Grenzgebirge
Lechtaler Alpen	Gruppe
Lederschwämme	Familie
Lee-Metford	Bezeichnung
Legat	Zuwendung
Legumin	Stoff
Lehre	Werkzeug
Leï	Mehrzahl
Leibgedinge	Rente
Leichentransport	Verbringung
Leistenführung	Führung
Leitton	Stufe
Leitungswiderstand	Widerstand
Leïxões	Seehafen
Lektüre	Lesen
Le-Maire-Straße	Meerenge
Lemnazeen	Unterfamilie
Lemuren	Familie
Lentitis	Entzündung
Leptá	Mehrzahl
Lethe	Strom
Leuchtfarbe	Gemisch
Leuchtsteine	Material
Leukadischer Fels	Südspitze
Leukämie	Erkrankung
Leukom	Folge
Leukoplakie	Bildung
Leukozyten	Blutkörperchen
Leuktra	Ortschaft
Leuzin	Zersetzungsprodukt
Liba	Oberlauf
Libellenquadránt	Instrument
Liberum Veto	Befugnis
Lic.	Abkürzung
Lichenin	Bestandteil
Licht	Ursache
Lidentzündung	Entzündung
Liderung	Abdichtung
Lidi	Mehrzahl
Liechtensteinklamm	Felsschlucht
Lieferzeit	Frist
Ligíst	Mitglied
Ligurische Alpen	Gruppe
Lika-Krbava	Komitat
Limakologie	Lehre
Limited	Zusatz
Limnimetrie	Zweig
Limonage	Bewässerung
Linienschiffe	Bezeichnung
Linsenkombination	Vereinigung
Linth	Oberlauf
Lion	Aufsehen
Lipämie	Vermehrung
Lipótvár	Strafanstalt
Lippfische	Familie
Lipurie	Ausscheidung
Lira	Mehrzahl
Liri	Oberlauf
Litholapaxie	Entfernung
Lithúrgik	Lehre
Litisdenunziation	Mitteilung
Livingston	Hafen
Ljublin	Gouvernement
Ljubotrn	Gipfel
Ljuk-tschun	Depression
Llummayor	Ortschaft
Loasazeen	Pflanzenfamilie
Lobeliazeen	Pflanzenfamilie
Loccum	Stift
Loci	Mehrzahl
Locus	Mehrzahl
Löffelgans	Bezeichnung
Lofoten	Gruppe
Log	Werkzeug
Loganiazeen	Pflanzenfamilie
Logik	Lehre
Lohnklassen	Grundlage
Loiret	Departement
Lokativ	Kasus
Lokodscha	Ortschaft
Lolodorf	Station
Lomsha	Gouvernement
London Purple	Mittel
Longitudinal	Länge
Lordship	Würde
Los	Entscheidung
Lotablenkung	Abweichung
Loten	Bestimmung
Löten	Vereinigung
Lotmaschine	Vorrichtung
Löwenbund	Gesellschaft
Lozère	Departement
Lpfd.	Abkürzung
Ltd.	Abkürzung
Luftansammlung	Ansammlung
Luftgewebe	Zellgewebe
Luleå-Ofoten-Bahn	Eisenbahn
Lungenhernie	Vorfall
Lungenprobe	Versuch
Lungensucht	Lungentuberkulose
Luv	Seite
Luv	Gegensatz
Luzerner Alpen	Bezeichnung
Lydtinscher Meßstock	Instrument
Lykeri	Gipfel
Lykische Sprache	Sprache
Lykoreia	Gipfel
Lymphatisches System	System
Lysa Gora	Höhenzug
Lysefjord	Zweig
Lysoform	Formaldehyd
MA.	Abkürzung
M.A.	Abkürzung
Macuba	Distrikt
Magalhãesländer	Bezeichnung
Magallanes	Territorium
Magenausspülung	Einführung
Magenentzündung	Entzündung
Magenschwäche	Neigung
Magenverhärtung	Verdickung
Magie	Kunst
Magistrale	Grundlinie
Magma	Salbe
Maidsurn	Kriegshafen
Maimakterion	Monat
Maimene	Gebirgsland
Mainau	Brücke
Maine-et-Loire	Departement
Mainlinie	Bezeichnung
Mainthal	Bezirk
Mairenke	Fisch
Majella	Gebirgsstock
Majunga	Hafen
Makâme	Mehrzahl
Makolololand	Gebirgsland
Makrobiotik	Kunst
Mala fides	Gegenteil
Malediven	Dependenz
Malghera	Brückenkopf
Malindi	Hafenplatz
Mall	Modell
Malz	Rohmaterial
Mammuthöhle	Höhle
Mamoré	Oberlauf
Manager	Leiter
Mandel	Frucht
Mangerai	Westteil
Manhattan Island	Staat
Manichäer	Anhänger
Manipulation	Anwendung
Mannheimer Gold	Messing
Mannjungfrauschaft	Abweichung
Manora-Sternwarte	Sternwarte
Mansa	Wurzel
Manteltiere	Kreis
Mapiainseln	Gruppe
Mapimi	Hochfläche
Mardelle	Unterbau
Mark	Einheit
Markgrafenland	Landstrich
Markieren	Zeichen
Märkische Schweiz	Gegend
Märkisch-Schlesischer Landrücken	Höhenzug
Markobrunn	Brunnen
Markscheide	Grenze
Marmaros	Komitat
Marqueß	Rangstufe
Marrahgebirge	Gebirgskette
Marsch	Bewegung
Marsdiep	Meerenge
Marsiliazeen	Pflanzenfamilie
Marston Moor	Moorfläche
Marterwoche	Karwoche
Martialis	Eisen
Marzolano	Stroh
Mâschallâh	Ausruf
Maschinenlehre	Lehre
Maskaríll	Figur
Maskulinum	Geschlecht
Mass.	Abkürzung
Massa	Anrede
Massa	Ausfluß
Massena	Rinde
Mássina	Gebiet
Mastdarmentzündung	Entzündung
Mastel	Pflanze
Mastitis	Entzündung
Masu	Hohlmaß
Masuren	Landesteil
Matadi	Hafenplatz
Matamoros	Figur
Materialíst	Anhänger
Mathematik	Wissenschaft
Mathesis	Mathematik
Mato Grosso	Staat
Matotschkin-Schar	Meerenge
Matta	Pulver
Matterhorn	Gipfel
Mattrah	Hafenplatz
Mauerfraß	Zerstörung
Mauerschwalben	Familie
Maulwürfe	Familie
Mayfeld	Landstrich
Mayonnaise	Sauce
Mazagran	Getränk
Mazedonianer	Anhänger
Mazocha	Erdfall
Mc	Abkürzung
m.c.	Abkürzung
Md.	Abkürzung
Me.	Abkürzung
Meat	Fleisch
Mechanik	Wissenschaft
Mechanisches Äquivalent der Wärme	Arbeitsmenge
Mechanisches Äquivalent des Lichts	Arbeitsmenge
Mechanische Wärmetheorie	Lehre
Mechanismus	Einrichtung
Mechanurgie	Lehre
Media gratiae	Media
Medial	Mitte
Median	Papierformat
Mediastinum	Mittel
Mediceisches Zeitalter	Blütezeit
Medien	Mehrzahl
Medizin	Heilkunst
Medizinieren	Arznei
Meeräschen	Familie
Meerbrassen	Familie
Meerdrachen	Familie
Meergrundeln	Familie
Meernägel	Deckel
Meernesseln	Bezeichnung
Meerschlangen	Familie
Mehs	Gewicht
Meisterprüfung	Prüfung
Me-kiang	Strom
Mekkabalsam	Balsam
Me-kong	Strom
Mekonium	Opium
Melanämie	Vorkommen
Melanurie	Ausscheidung
Melastomazeen	Pflanzenfamilie
Melibokus	Gipfel
Mellarosa	Abart
Melpomene	Vertreterin
Memel	Unterlauf
Menäen	Mehrzahl
Meninx	Hirnhaut
Menispermazeen	Pflanzenfamilie
Mennighüffen	Bauerschaft
Menschensohn	Selbstbezeichnung
Menses	Mehrzahl
Menzies	Mittelpunkt
Mer de Glace	Gletscher
Merka	Hafenplatz
Merlin	Zauberer
Merostomen	Ordnung
Merowinger	Geschlecht
Mers el-Kebir	Hafen
Merwara	Gebiet
Merwe	Unterlauf
Mes	Gewicht
Meschid-i-Ser	Hafen
Meßgewand	Kleidung
Messiade	Bezeichnung
Messieurs	Plural
Messin	Umgebung
Messrs.	Abkürzung
Mesurado	Vorgebirge
Meteorolog	Witterung
Meteorwasser	Schnee
Meter	Grundmaß
Methämoglobin	Verbindung
Methylviolett	Gemenge
Metonomasie	Veränderung
Metonymie	Vertauschung
Metrik	Wissenschaft
Metrologie	Lehre
Meuterei	Vereinigung
M.E.Z.	Abkürzung
Mezquitesträucher	Vegetationsform
mf.	Abkürzung
M'Gladbach	Abkürzung
Mich.	Abkürzung
Michoacán	Staat
Micrococcus	Sammelname
Mikromanie	Gegensatz
Mikroskopische Technik	Gesamtheit
Mikrotelephon	Verbindung
Mikrotom	Instrument
Milben	Ordnung
Milchner	Fisch
Militärhoheit	Staatsgewalt
Militärmaß	Mindestmaß
Militärstrafprozeß	Verfahren
Milreïs	Geldeinheit
Mimik	Kunst
Minargent	Legierung
Minn.	Abkürzung
Minsk	Gouvernement
Miotika	Pupille
Mirditen	Stamm
Miseno	Vorgebirge
Miss.	Abkürzung
Missionen	Gebiet
Mit Gott für König und Vaterland	Devise
Mitidja	Ebene
MK	Abkürzung
mkg	Abkürzung
M.M.	Abkürzung
Mnemonik	Kunst
Mo.	Abkürzung
Moansa	Station
Mobangi	Mittellauf
Mobiliargemeinschaft	Gemeinschaft
Modéll	Darstellung
Modellieren	Wachs
Modrus-Fiume	Komitat
Modulation	Übergang
Mogilew	Gouvernement
Mogistan	Küstenstrich
Mojanga	Hafen
Molasse	Glied
Moleküle	Teilchen
Molken	Flüssigkeit
Mollner Alpen	Gruppe
Molluskoiden	Kreis
Momént	Augenblick
Monaco	Fürstentum
Monaden	Unterordnung
Mönch	Stempel
Monddistanzen	Entfernung
Mondsüchtigkeit	Zustand
Moniliakrankheit	Krankheit
Monísmus	Ansicht
Monita	Mehrzahl
Monmeh	Einheit
Monochórd	Instrument
Monogamie	Verbindung
Monographie	Schrift
Monomanie	Bezeichnung
Monometallismus	System
Monophasie	Sprachstörung
Monophysiten	Anhänger
Monorchismus	Fehlen
Monotheïsmus	Verehrung
Monotheleten	Anhänger
Monseigneur	Prädikat
Monsieur	Mehrzahl
Monsignore	Titel
Mont-aux-Sources	Gipfel
Mont-Collon	Bergstock
Monte Baldo	Bergzug
Monte Braulio	Gipfel
Montejus	Vorrichtung
Mont-Pelvoux	Bergmassiv
Mont-Perdu	Gipfel
Montrose Burghs	Gruppe
Montserrado	Vorgebirge
Moosberg	Scheitelpunkt
Moostierchen	Klasse
Mora	Spiel
Morbillen	Masern
Morelos	Staat
Morgarten	Bergabhang
Morgenroth	Kolonie
Morgenstern	Planet
Mormugao	Hafen
Morphologie	Lehre
Mosaïsmus	Inbegriff
Moslem	Mehrzahl
Mosuto	Singular
Motilitätsneurosen	Nervenleiden
Motiv	Triebfeder
Möwen	Familie
M.P.	Mitglied
Mpapua	Bezirk
Mrs.	Abkürzung
m.s.	Abkürzung
Mücken	Unterordnung
Mudirieh	Bezeichnung
Mugán	Steppe
Mumie	Deckel
Mundari	Stamm
Mundharmonika	Instrument
Münzhoheit	Inbegriff
Münzregal	Recht
Murmansche Küste	Nordküste
Muschel	Kalkschale
Muschelkrebse	Ordnung
Muschelvergiftung	Vergiftung
Musikalienhandel	Vertrieb
Musivsilber	Legierung
Muskarin	Stoff
Muskelatrophie	Abnahme
Muskelelektrizität	Wirksamkeit
Muskelfaradisation	Erregung
Muskular	Gesamtheit
Mussumba	Residenz
Mustapha Bairaktár	Vertreter
Musterschutz	Schutz
Musteschar	Titel
Mutieren	Stimme
Mutterpflaster	Hamburger
Myelitis	Verhärtung
Mykologie	Lehre
Mylitta	Personifikation
Mylord	Anrede
Myokardium	Entzündung
Myrikazeen	Pflanzenfamilie
Myringitis	Entzündung
Mystifizieren	Leichtgläubigkeit
Mystik	Bestreben
Mystisch	Mystik
Myxobakterien	Gruppe
Nacheile	Recht
Nachforderungsrecht	Recht
Nachhaft	Unterbringung
Nach Kanossa gehen wir nicht	Ausspruch
Nachstar	Bezeichnung
Nagetiere	Ordnung
Nähmaschine	Mechanismus
Naiden	Familie
Naksch-i-Rustem	Nekropole
Narkose	Gefühllosigkeit
Narzein	Alkaloid
Nase	Fisch
Nashornvögel	Familie
Nasir	Titel
Nasoräer	Selbstbezeichnung
Nassau	Vorgebirge
Nasser Weg	Chemie
Nation	Gesamtheit
Natisone	Oberlauf
Nativismus	Lehre
Natronsee	Salzsee
Naturalisation	Erteilung
Naturalwirtschaft	Stufe
Natura non facit saltus	Natur
Naturfarbendruck	Verfahren
Naturgeschichte	Ausdruck
Naturheilkunde	Lehre
Naturheilung	Heilung
Naturlehre	Physik
Naturvölker	Bezeichnung
Naturwissenschaft	Inbegriff
Nauárch	Titel
Naulette	Höhle
Naval	Seewesen
Navigierung	Gesamtheit
Naviglio Grande	Kanal
n.B.	Abkürzung
N.C.	Abkürzung
Neanderhöhle	Höhle
Nearthrose	Bildung
Nebalien	Familie
Nebenklage	Anschluß
Nebenplaneten	Körper
Nebenwinkel	Winkel
Nebireh	Ruinenstätte
Nedschd	Hochland
Negativdruck	Verfahren
Negra	Hafen
Negus	Titel
Nekrolog	Biographie
Nemesis	Verkörperung
Neograd	Komitat
Neologie	Einführung
Nepenthazeen	Pflanzenfamilie
Nephrops	Gattung
Nereiden	Familie
Nervengeflecht	Verbindung
Nervenkerne	Anhäufung
Nervös	Nerven
Netzflügler	Ordnung
Netzhautentzündung	Entzündung
Neuenburg	Kanton
Neufchâtel	Kanton
Neulauenburg	Gruppe
Neuroretinitis	Entzündung
Neurose	Nervenkrankheit
Neutragebirge	Gebirgskette
Neuzelle	Stift
New Shoreham	Hafenplatz
N.H.	Abkürzung
Niadi	Oberlauf
Niari	Oberlauf
Nibelungenstrophe	Strophenform
Nidwalden	Halbkanton
Niederfränkisch	Gruppe
Nießbrauch	Recht
Nieuwediep	Hafen
Nièvre	Departement
Nigersaat	Samen
Nilgiri	Gebirgskette
Nilhechte	Familie
Nisam	Reich
Nishnij Nówgorod	Gouvernement
Nitrose	Zwischenprodukt
Nivose	Monat
Nixdorf	Industriedorf
Nomen	Mehrzahl
Nomina	Mehrzahl
Nomina sunt odiosa	Namen
Nomos	Musikstück
Nonnenstromberg	Gipfel
Nonsberger Alpen	Gruppe
Nordenham	Bauerschaft
Nordkanal	Meerenge
Nordstern	Polarstern
Northumberlandstraße	Meerenge
Nosogenie	Entstehung
Nostochazeen	Familie
Nostrifikation	Erteilung
Notabeln	Bildung
Notrecht	Befugnis
Nottaufe	Taufe
Notzucht	Verbrechen
Nova	Mehrzahl
Novantik	Antike
Noviziat	Probezeit
Nówgorod	Gouvernement
Nuces	Mehrzahl
Nukuóroinseln	Gruppe
Nullpunkt	Anfangspunkt
Num. Ap.	Abkürzung
Nürnberger Eier	Benennung
Nußrâni	Benennung
Nut	Rinne
Nutation	Veränderung
N.Y.	Abkürzung
Nyktaginazeen	Pflanzenfamilie
Nymphäazeen	Pflanzenfamilie
Nymphaliden	Unterfamilie
Nyx	Nacht
O.	Abkürzung
Oberbayern	Regierungsbezirk
Oberelsaß	Bezirk
Oberfranken	Regierungsbezirk
Oberhessen	Nordhälfte
Oberstaatsanwalt	Bayern
Objektives Strafverfahren	Verfahren
Ob-Jenisseisches Kanalsystem	Wasserstraße
Obok	Hafen
Obwalden	Halbkanton
Ochill Hills	Gebirgskette
Octopoda	Unterordnung
Offensiv	Angriff
Ogham	Schrift
Ogowe	Strom
Ohr	Organ
Ohrenprobe	Untersuchung
Ohrenrobben	Familie
Ohrwürmer	Familie
o.J.	Abkürzung
Okklusionsvermögen	Eigenschaft
Oklahoma	Territorium
Ökologie	Zweig
Oktav	Druckformat
Oktodez	Druckformat
Oktopoden	Unterordnung
Okzidént	Westen
Okzipital	Hinterhaupt
ö.L.	Abkürzung
Olbersdorf	Industriedorf
Ölheim	Ortschaft
Oligarchie	Herrschaft
Oligozythämie	Verminderung
Ölmalerei	Kunst
Olónez	Gouvernement
Ölzucker	Mischung
Omân	Staat
Omeganebel	Nebelfleck
Omen	Mehrzahl
Onagrazeen	Pflanzenfamilie
Onkologie	Lehre
Onomatologie	Lehre
Önometer	Instrument
Ontostatik	Theorie
Onus	Mehrzahl
Onyx	Abart
Op.	Abkürzung
Opera	Mehrzahl
Opferstock	Behälter
Ophiten	Anhänger
Opiat	Opium
Opium	Milchsaft
Opopanax	Gummi
Optik	Lehre
Optimismus	Auffassung
Optometer	Instrument
Or.	Abkürzung
Orbis	Titel
Orderhafen	Hafen
Ordines	Mehrzahl
Ordu	Bezeichnung
Oreg.	Abkürzung
Orenburg	Gouvernement
Oreodónten	Gruppe
Orient	Morgen
Ormonts	Hochtal
Ornithologische Beobachtungsstationen	Beobachtung
Ornithopteren	Gattung
Orthoëpie	Lehre
Orthoskopisch	Bezeichnung
Ortsname	Bezeichnung
Ortssinn	Fähigkeit
Ortsunterkunft	Unterbringung
Oryktogenie	Entstehung
Oskulation	Berührung
Osmologie	Lehre
Osmose	Austausch
Ösophagus	Krampf
Osterzyklus	Periode
Ostrau	Pädagogium
Ot	Gipfel
Öta	Gebirgskette
Otjiherero	Sprache
Otterbeinleute	Zweig
Ötztal	Seitental
ö.W.	Abkürzung
Oxalideen	Pflanzenfamilie
Oxygenium	Sauerstoff
Oxyliquit	Bezeichnung
oz.	Abkürzung
Ozark Mountains	Gebirgszug
Pa.	Abkürzung
pa	Abkürzung
p.a.	Abkürzung
Paarzeher	Ordnung
Pacaraima	Gebirgskette
Pachymeningitis	Entzündung
Pacific	Abkürzung
Pactum	Mehrzahl
Pädarthrokace	Gelenkentzündung
Paddy	Abkürzung
Päderastie	Unzucht
Pädogenesis	Erzeugung
Pädotrophie	Ernährung
pag.	Abkürzung
Pago-Pago	Hafen
Paj-choj	Gebirgszug
Palagruppe	Gruppe
Paläographie	Wissenschaft
Palatinat	Würde
Pali	Abkömmling
Palisadenwürmer	Familie
Palliativ	Mittel
Palmas	Vorgebirge
Palmesel	Abbild
Palmkerne	Samen
Palmoskopie	Beobachtung
Panamá	Landenge
Panazee	Heilmittel
Pandit	Titel
P. and O. Comp.	Abkürzung
Panhellenismus	Streben
Pankreatitis	Entzündung
Pannonien	Ungarn
Panorama	Gesamtbild
Panotitis	Entzündung
Panslawismus	Bestreben
Pantelegraph	Bezeichnung
Pantheïsmus	Bezeichnung
Panther	Gruppe
Pantograph	Instrument
Pantscharatra	Namen
Panzerkrebse	Familie
Papabiles	Aussicht
Papageien	Ordnung
Papaverin	Alkaloid
Paplika	Tropfsteinhöhle
Pappus	Figur
Paradiesvögel	Familie
Paragenesis	Lehre
Paragons	Bezeichnung
Paragua	Oberlauf
Parallaktische Aufstellung	Aufstellung
Paralláxe	Winkel
Parallelismus	Verhältnis
Parametritis	Entzündung
Paraná	Küstenstaat
Paraná-Panema	Grenze
Parazentese	Eröffnung
Parentel	Gesamtheit
Parlamentarier	Mitglied
Parnes	Grenzgebirge
Parochie	Fremde
Parthenogenesis	Hervorbringung
Parturiunt montes	Berge
Parulis	Entzündung
Paruschowitz	Kolonie
Pascha	Titel
Passade	Bewegung
Passiergewicht	Gewicht
Passion	Leiden
Paste	Arzneimittel
Pasterze	Gletscher
Pathogen	Krankheit
Pathogenese	Lehre
Pathognomik	Kunst
Pathologie	Lehre
Patience	Kartenspiel
Patres	Mehrzahl
Patriarchat	Würde
Patrimonium	Vermögen
Paxos	Nomos
Pazifikation	Zurückführung
Paziszieren	Vergleich
Peak von Derby	Hochland
Pebrine	Krankheit
Pedochio	Hafen
Pehtha	Gewicht
Peilen	Richtung
Peitlerkofel	Gipfel
Pekinghuhn	Zwergform
Pekulium	Vermögen
Pekuniär	Vermögen
Pelham	Vereinigung
Pelikan	Instrument
Pelion	Waldgebirge
Pellotin	Alkaloid
Peloponnesischer Krieg	Kampf
Pelorienbildung	Umbildung
Penarth	Hafen
Pence	Mehrzahl
Penis	Glied
Penny	Mehrzahl
Penrhyn	Hafen
Pensa	Gouvernement
Pentland Firth	Meerenge
Pentland Hills	Gebirgszug
P.e.o.	Abkürzung
Peppi	Abkürzung
Pepsin	Ferment
Père-Lachaise	Kirchhof
Perfékt	Glaube
Perianthium	Blütenhülle
Periculum	Gefahr
Peridérm	Gewebe
Perigon	Blütenhülle
Perikárd	Herzbeutel
Perikitten	Bezeichnung
Perimeter	Umfang
Perimetritis	Entzündung
Peripherie	Umfang
Periphlebitis	Entzündung
Peripleuritis	Entzündung
Períplus	Titel
Perispérm	Zellgewebe
Perizystitis	Entzündung
Perlhühner	Unterfamilie
Perlmutterfalter	Gattung
Perm	Abkürzung
Perm	Gouvernement
Personalunion	Vereinigung
Personenrecht	Inbegriff
Personifikation	Darstellung
Perspektive	Aussicht
Perspiration	Ausdünstung
Petroków	Gouvernement
Pfand	Gegenstand
Pfauen	Unterfamilie
Pfebe	Kürbis
Pfefferrinde	Rinde
Pfeifhase	Gattung
Pfeilwürmer	Gruppe
Pflanzenchemie	Lehre
Pflanzenläuse	Unterordnung
Pflanzenwespen	Gruppe
Phallus	Glied
Phänologie	Zweig
Phantasie	Tätigkeit
Pharmazie	Gesamtheit
Pharyngitis	Entzündung
Pharyngognathen	Ordnung
Pharyngologie	Lehre
Phasis	Strom
Phaskazeen	Familie
Philharmonisch	Tonkunst
Philologie	Wissenschaft
Phlegräische Felder	Schauplatz
Phonautograph	Vorrichtung
Phonetik	Lehre
Phonik	Lehre
Phönizisches Feuer	Lösung
Phoronomie	Lehre
Phosphoreszénz	Eigenschaft
Photochemie	Lehre
Photometer	Vorrichtung
Photoskulptur	Nachbildung
Photosphäre	Oberfläche
Phykologie	Lehre
Phykomyzeten	Gruppe
Phyllomedusen	Familie
Physiater	Heilkraft
Physik	Lehre
Physik	Bezeichnung
Physikalisch	Physik
Physiologus	Titel
Physionomie	Lehre
Phytolakkazeen	Pflanzenfamilie
Piëdestal	Untersatz
Pien-wai	Landstrich
Piëzoelektrizität	Eigenschaft
Pigméntatrophie	Schwund
Pik	Farbe
Pikettspiel	Kartenspiel
Pillen	Arzneimittel
Pilokarpin	Alkaloid
Pilzmücken	Familie
Pimelosis	Fettsucht
Pinetum	Anpflanzung
Pinzgau	Längstal
Pioskop	Instrument
Pique	Farbe
Pisistratiden	Bezeichnung
Piso	Familie
Pithometer	Instrument
Pitotsche Röhre	Vorrichtung
Pla	Hafen
Plachmal	Gemisch
Plagiat	Aneignung
Planimeter	Instrument
Plankammer	Sammlung
Plankton	Gesamtheit
Plantaginazeen	Pflanzenfamilie
Plantation	Hafenplatz
Plata	Strom
Platanazeen	Pflanzenfamilie
Plattfuß	Verunstaltung
Platthufer	Ordnung
Plattieren	Oberfläche
Plebejer	Mitglied
Pleomorphismus	Eigentümlichkeit
Plessuralpen	Gruppe
Plethomelie	Mißbildung
Plexus	Verbindung
Plöckenstein	Gipfel
Plöcklstein	Gipfel
Plongé	Abdachung
Plötzensee	Kolonie
Plozk	Gouvernement
Pluralismus	Vorhandensein
Plutonisten	Anhänger
Pneumatismus	Materie
Pneumatizität	Eigentümlichkeit
Pneumatologie	Lehre
Pneumatotherapie	Anwendung
Podést	Absatz
Podolien	Gouvernement
Poetik	Theorie
Poik	Oberlauf
Poil	Decke
Points	Mehrzahl
Pokutien	Landstrich
Polarisation	Erscheinung
Polarität	Vorhandensein
Poldistanz	Entfernung
Polhöhe	Bogen
Polieren	Oberfläche
Polioenkephalitis	Entzündung
Polnische Sprache	Glied
Polnisches Recht	Zweig
Polsucher	Einrichtung
Poltáwa	Gouvernement
Polyarchie	Herrschaft
Polyästhesie	Erscheinung
Polyautographie	Vervielfältigung
Polychromie	Bemalung
Polyembryonie	Vorkommen
Polygalazeen	Pflanzenfamilie
Polyglotte	Inhalt
Polygonazeen	Pflanzenfamilie
Polymastie	Vorhandensein
Polyphon	Vielstimmigkeit
Polypodiazeen	Pflanzenfamilie
Polypomedusen	Klasse
Pomeranzenelixier	Mischung
Pomeranzenschale	Schicht
Pondoland	Distrikt
Ponerologie	Lehre
Pönologie	Lehre
Porta Hungarica	Durchbruch
Port Durnford	Hafen
Port Famine	Hafen
Port-Launay	Seehafen
Port Moresby	Hafen
Porto	Mehrzahl
Porto do Ilheo	Hafen
Porto Bathy	Hafen
Porträt	Bildnis
Port Rush	Hafen
Porzellan	Erzeugnis
Positur	Haltung
Postamént	Unterlage
Posten	Schrot
Postkommunion	Schlußteil
Postkongreß	Vereinigung
Postliminium	Recht
Postporto	Gebühr
Postremität	Stellung
Potala	Residenz
Potential	Möglichkeit
Potio	Trinken
Potosí	Staat
Poule	Einsatz
P.P.	Abkürzung
Prachtfinken	Gruppe
Prägen	Verfahren
Prägen	Leder
Präkordien	Gegend
Präpositus	Stelle
Präraffaëliten	Gruppe
Präsepe	Mehrzahl
Präses	Mehrzahl
Prättigau	Hochtal
Prävalieren	Oberhand
Praxis	Lehre
Präzedéns	Mehrzahl
Preßrecht	Gesamtheit
Prevorst	Weiler
Primaten	Mehrzahl
Primordialstufe	Schicht
Primulazeen	Pflanzenfamilie
Prince Confort	Titel
Principes	Treffen
Prinz	Titel
Prinzipat	Würde
Priorität	Recht
Probierkunst	Untersuchung
Produktion	Erzeugung
Produktivität	Leistungsfähigkeit
Profít	Nutzen
Progreso	Hafen
Proktalgie	Schmerz
Prolongation	Verlängerung
Promemoria	Eingabe
Promenade	Anlage
Promontore	Südspitze
Pronomen	Mehrzahl
Proömium	Eingang
Propagánda	Gesellschaft
Propionsäure	Essigsäure
Prosa	Sprache
Prosenchym	Pflanzengewebe
Prosodie	Zeitverhältnis
Protozoen	Kreis
Provence-Alpen	Gruppe
Provinzialordnung	Gesetz
Provision	Versorgung
Provost	Titel
Proxenie	Recht
Proz.	Abkürzung
Prozeßvollmacht	Ermächtigung
pr.pa.	Abkürzung
Pr.pr.	Abkürzung
Prunkottern	Familie
PS	Abkürzung
Pskow	Gouvernement
Psychologie	Wissenschaft
Psychometrie	Messung
Psychopathologie	Lehre
Psychotherapie	Heilung
Pterichthys	Gattung
Pterygotus	Gattung
Publikaner	Bezeichnung
Puchtu	Sprache
Puebla	Bundesstaat
Puërto de la Libertád	Hafen
Puërto Mahon	Hafen
Puff	Brettspiel
Pulpitis	Entzündung
Pulque	Lieblingsgetränk
Punctum	Stelle
Punktierkunst	Erforschung
Punktion	Durchtrennung
Punktur	Stich
Punsch	Rasse
Puppenräuber	Gattung
Purismus	Streben
Purpurschnecken	Familie
Puschtu	Sprache
Putbus	Nebenlinie
pwt.	Abkürzung
pxt.	Abkürzung
Pyknodonten	Familie
Pylephlebektasie	Entzündung
Pylos	Residenz
Pyrenomyzeten	Unterfamilie
Pyrometer	Vorrichtung
Quadriënnium	Zeitraum
Quadrireme	Schiff
Quadrupelallianz	Spanien
Quarta	Klasse
Quartär	Stelle
Quartétt	Tonsatz
Quarzporphyr	Gestein
Quastenflosser	Ordnung
Quaestio	Frage
Quaebrachorinde	Rinde
Queda	Staat
Querzitron	Rinde
Quiche	Gruppe
Quinquennium	Zeitraum
Quiproquo	Verwechslung
Quitt	Verbindlichkeit
Quitte	Frucht
Quote	Anteil
Rachentonsille	Anhäufung
Racken	Familie
Rädertiere	Klasse
Radiator	Bezeichnung
Radien	Mehrzahl
Radioaktivität	Eigenschaft
Radiographie	Untersuchung
Radius	Mehrzahl
Radizieren	Wurzel
Radom	Gouvernement
Radschmahal	Stamm
Radspinnen	Unterordnung
Raffinose	Zuckerart
Ragout	Gericht
Raid	Unternehmung
Raketenapparat	Vorrichtung
Rall.	Abkürzung
Ralum	Station
Ramisten	Anhänger
Ramme	Werkzeug
Ramu	Oberlauf
Rankenfüßer	Ordnung
Ranunkulazeen	Pflanzenfamilie
Ranzion	Lösegeld
Rapfen	Fisch
Rastral	Instrument
Rat	Titel
Ratafia	Weingeist
Ratanhiawurzel	Wurzel
Rationalíst	Anhänger
Ratteninseln	Gruppe
Räuberromane	Abart
Raubfliegen	Familie
Raubvögel	Ordnung
Raubwanzen	Familie
Raubwespen	Gruppe
Räude	Krätze
Raudische Felder	Ebene
Rauhfußhühner	Unterfamilie
Rauhfutter	Viehfutter
Ravensara	Samen
Reader	Titel
Reagens	Mehrzahl
Realismus	Auffassung
Rechtschreibung	Lehre
Rechtsfähigkeit	Fähigkeit
Rechtsfähigkeit	Träger
Rechtshängigkeit	Zustand
Rechtsphilosophie	Inbegriff
Rechtsritter	Stufe
Redefreiheit	Recht
Redekunst	Fähigkeit
Redscheb	Monat
Referendar	Sachsen
Refórm	Umänderung
Reformaten	Zweig
Reformgymnasium	Schule
Reformíst	Anhänger
Refugio	Hafen
Refugium	Bezeichnung
Regenpfeifer	Familie
Regenwürmer	Unterordnung
Regulus	Stern
Rehposten	Schrot
Reichsadel	Gesamtheit
Reichspostmuseum	Sammlung
Reihe	Aufeinanderfolge
Reiher	Familie
Reim	Gleichklang
Reimchroniken	Geschichte
Reisebuchhandel	Zweig
Reißkofelgruppe	Gruppe
Reitkunst	Inbegriff
Reklamation	Beschwerde
Reklamieren	Beschwerde
Rekontrafechten	Vereinigung
Rektitis	Entzündung
Religionsgeschichte	Erforschung
Reliktenfauna	Gesamtheit
Remontantrosen	Klasse
Rennarbeit	Darstellung
Rentenrechnung	Berechnung
Reptilien	Klasse
Resedazeen	Pflanzenfamilie
Resistieren	Widerstand
Resp.	Abkürzung
Respirator	Instrument
Retentionsrecht	Befugnis
Retina	Netzhaut
Retinitis	Entzündung
Retrákt	Losung
Reüssieren	Erfolg
Réverend	Titel
Rezéß	Endergebnis
rf.	Abkürzung
Rhabdocölen	Unterordnung
Rhätische Alpen	Gruppe
Rheina-Wolbeck	Standesherrschaft
Rheinkopf	Gipfel
Rhein-Ruhr-Kanal	Verbindung
Rheologie	Zweig
Rheostatische Maschine	Vorrichtung
Rhetorik	Theorie
Rhineurynter	Instrument
Rhiniatrik	Entzündung
Rhinologie	Lehre
Rhinwasserstraße	Kanal
Rhion	Vorgebirge
Rhizoiden	Funktion
Rhythmik	Lehre
Ricciazeen	Familie
Rigel	Stern
Rindenschwämme	Ordnung
Rindern	Brunst
Ringelwürmer	Klasse
Ringgoldinseln	Gruppe
Rio Grande del Norte	Strom
Rio Hacha	Hafen
Ritterakademie	Erziehungsanstalt
Ritual	Vorschrift
Rjasan	Gouvernement
rm	Abkürzung
R.O.	Abkürzung
Rochen	Unterordnung
Rocky Mountains	Felsengebirge
Rodnaer Gebirge	Gruppe
Roggeveld	Gebirgszug
Rohrblatt	Bestandteil
Röhren	Schreien
Röhrenmäuler	Familie
Röhrenquallen	Ordnung
Röhrenspinnen	Unterordnung
Rohrpost	Einrichtung
Rohrzucker	Zucker
Roosbeen	Bezeichnung
Roosebeke	Ortschaft
Rösche	Stollen
Roßbreiten	Gürtel
Rotation	Bewegung
Rotationspolarisation	Eigenschaft
Röte	Krankheit
Rote Erde	Bezeichnung
Rote Nase	Kupferrose
Roter Brenner	Krankheit
Roter Sand	Untiefe
Rotfink	Bezeichnung
Rotfuchs	Fuchs
Rothaargebirge	Bergzug
Rottenmünster	Weiler
Roulette	Werkzeug
Rousseletten	Klasse
Rouxgewehr	Umbildung
Royalismus	Anhänglichkeit
Rubel	Einheit
Rückenmarkserschütterung	Erkrankung
Rückrechnung	Rechnung
Ruder	Vorrichtung
Ruderenten	Familie
Ruderfüßler	Ordnung
Rudnik	Kreis
Rufisque	Hafenplatz
Rundwürmer	Klasse
Ruotsinsalmi	Meerenge
Ruscus	Pflanzengattung
Ruß	Krankheit
Rüssel	Organ
Rüsseltiere	Ordnung
Rüstkammer	Sammlung
Saarkohlenkanal	Schiffahrtskanal
Sabbaterweg	Strecke
Sabismus	Lehre
Saccharimetrie	Bestimmung
Sachsen-Merseburg	Nebenlinie
Sachsen-Weißenfels	Nebenlinie
Sachsen-Zeitz	Nebenlinie
Sackspinnen	Familie
Sacristitium	Einstellung
Sadr	Titel
Säger	Familie
Sägeracken	Familie
Saillant	Winkel
Saki	Salzsee
Saladillo	Unterlauf
Salaïrkette	Ausläufer
Sala y Gomez	Chile
Salikazeen	Pflanzenfamilie
Salix	Weide
Salmis	Hafen
Salpen	Klasse
Salpeterschwefelsäure	Gemisch
Salutisten	Anhänger
Salzburger Kalkalpen	Gruppe
Salzburger Schieferalpen	Gruppe
Salzsäure	Lösung
Samára	Gouvernement
Samarkand	Gebiet
Sambakí	Anhäufung
Samendarre	Anstalt
Samenkäfer	Familie
Samhara	Küstenland
Samt	Gewebe
Sanatorium	Anstalt
Sandfischhafen	Hafen
Sandkäfer	Unterfamilie
Sandstein	Gemenge
Sandstrahlgebläse	Vorrichtung
Sandwürmer	Familie
Sänfte	Beförderungsmittel
Sänger	Familie
Sanitätskorps	Gesamtheit
Sanitätswesen	Organisation
San-Juan-de-Fuca-Straße	Meeresstraße
Sansara	Kreislauf
Sanskrit	Sprache
São Francisco	Strom
Saprämie	Allgemeinerkrankung
Saprol	Gemisch
Sarátow	Gouvernement
Sarca	Oberlauf
Sardine	Fisch
Sardonagruppe	Gruppe
Sarkodetierchen	Klasse
Sarkolemma	Hülle
Sáros	Komitat
Sarrazeniazeen	Pflanzenfamilie
Saterland	Moorlandschaft
Satsuma	Distrikt
Satúrn	Planet
Säugetiere	Klasse
Savoyen	Stammland
Savoyer Alpen	Gruppe
Sáwakot	Zweig
s.B.	Abkürzung
Schaben	Familie
Schablone	Muster
Schachen	Aussichtspunkt
Schafkopf	Spiel
Schahsade	Titel
Schake	Glied
Schall	Bezeichnung
Schammar	Staat
Schanfigg	Hochtal
Schanker	Geschwür
Schardagh	Gebirgskette
Scharley	Gutsbezirk
Scharlotte	Pudding
Schatz	Vorrat
Schauspiel	Gattung
Schauspielkunst	Kunst
Schawine	Abfall
Schehol	Sommerresidenz
Scheibenpilze	Ordnung
Scheibenzüngler	Familie
Schellah	Stamm
Schenkelhalsbruch	Bruch
Scheol	Hölle
Scherî'a	Gesetz
Scherîf	Titel
Scherzo	Tonsatz
Schicht	Arbeitszeit
Schiefheit	Verkrümmung
Schielen	Stellung
Schießprügel	Morgenstern
Schiffahrt	Verkehr
Schiffskreisel	Vorrichtung
Schiffsvermessung	Ermittlung
Schiffsvermögen	Bezeichnung
Schildbürger	Sammlung
Schildkröten	Ordnung
Schildläuse	Familie
Schipkahöhle	Höhle
Schippen	Farbe
Schizäazeen	Pflanzenfamilie
Schladminger Alpen	Gruppe
Schlafsucht	Trieb
Schlangen	Ordnung
Schlangenfische	Familie
Schleimfische	Familie
Schlern	Bergstock
Schlingern	Bewegung
Schloß	Vorrichtung
Schlottergelenk	Gelenk
Schlund	Übergang
Schlüsselrecht	Befugnis
Schmelzen	Übergang
Schmieden	Formgebung
Schminke	Mittel
Schnabelfliegen	Familie
Schnalser Tal	Seitental
Schnarrposten	Einzelposten
Schnecken	Klasse
Schneegrenze	Linie
Schneekopf	Spitze
Schneidklinge	Werkzeug
Schnelläufer	Unterordnung
Schnellfluß	Gemenge
Schnepfen	Familie
Schnepfenthal	Erziehungsanstalt
Schnupfen	Katarrh
Schöllenen	Felsschlucht
Schonnebeck	Bauerschaft
Schoo	Hohlmaß
Schopfhühner	Familie
Schorlemorle	Getränk
Schrank	Abstand
Schraubzwinge	Werkzeug
Schreivögel	Unterordnung
Schrift	Darstellung
Schugnan	Bergland
Schumava	Südhälfte
Schuppenfisch	Bezeichnung
Schuppenflosser	Familie
Schuppenkrankheit	Bezeichnung
Schute	Benennung
Schütte	Krankheit
Schutz	Zahlung
Schutzfrist	Zeitraum
Schwachstromtechnik	Zweig
Schwaden	Reihe
Schwägerschaft	Verhältnis
Schwalben	Familie
Schwalbenschwanz	Maschinenteil
Schwangerschaft	Zustand
Schwanz	Verlängerung
Schwanzlurche	Ordnung
Schwärmer	Familie
Schwarzreutel	Saibling
Schwefelsäure	Verbindung
Schwerpunkt	Punkt
Schwertfische	Familie
Schwertschwänze	Ordnung
Schwestern	Bezeichnung
Schwimmpolypen	Ordnung
Schwindflechte	Hautkrankheit
Schyn	Felsschlucht
Scillyinseln	Gruppe
Scindiah	Titel
Scriptum	Mehrzahl
S.D.G.	Abkürzung
S.E.	Abkürzung
sec	Abkürzung
s.e.c.	Abkürzung
Seceders	Anhänger
Sech	Messer
Sechsundsechzig	Kartenspiel
Sedez	Format
Sedisvakánz	Erledigung
Seegeltung	Macht
Seehunde	Familie
Seeigel	Klasse
Seekadett	Bezeichnung
Seekrähe	Bezeichnung
Seekühe	Familie
Seelenblindheit	Unvermögen
Seepier	Sandpier
Seeraupen	Familie
Seerecht	Inbegriff
Sefidrud	Unterlauf
Segu	Gebiet
Sehwinkel	Winkel
Seide	Gespinst
Seilebene	Vorrichtung
Seiltrommel	Trommel
Seine	Strom
Seismologie	Lehre
Seißer Alm	Hochebene
Sekundär	Gegensatz
Selam	Friede
Sellagruppe	Bergstock
Seminar	Anstalt
Semiotik	Lehre
Semipalatínsk	Gebiet
Semirjetschénsk	Gebiet
Semissis	Hälfte
Semitismus	Bezeichnung
Sen.	Abkürzung
Senfsamen	Samen
Senkrücken	Krümmung
Senkung	Taktteil
Sennesblätter	Blättchen
Septémvir	Mitglied
Septiko-Pyämie	Verbindung
Sepulkral	Begräbnis
Seraskier	Titel
Seravezza	Ortschaft
Serben	Einzahl
Sergeant	Titel
Sergipe	Küstenstaat
Serimeter	Instrument
Serra do Mar	Küstengebirge
Servante	Gestell
Servitut	Recht
Sesto Fiorentino	Ortschaft
Sesvete	Ortschaft
Setigera	Familie
Sette Comuni	Sieben
Seulingswald	Sandsteingebirge
Sewage	Bewässerung
Sewastópol	Kriegshafen
Sexennium	Zeitraum
Sextakkord	Umkehrung
Sexte	Intervall
Seychellen	Gruppe
sh.	Abkürzung
Shamrock	Symbol
Shylock	Charakter
Sicherheitskessel	Bezeichnung
Sicht	Zeitpunkt
Siderísmus	Vermögen
Siebenhonnschaften	Bauerschaft
Siedelungskunde	Zweig
Siedeverzug	Erscheinung
Siedlce	Gouvernement
Siegel	Abdruck
Siegelmäßigkeit	Befugnis
Sieker	Bauerschaft
Sigeum	Vorgebirge
Signore	Mehrheit
Sila	Gebirgsstock
Silbe	Gesamtheit
Silbergewicht	Gewicht
Sillabub	Getränk
Silvretta	Gebirgsstock
Simarubazeen	Pflanzenfamilie
Simbirsk	Gouvernement
Similor	Tombak
Simmenalpen	Gruppe
Simplum	Mehrzahl
Simpsonhafen	Hafen
sin	Abkürzung
Sindon	Mehrzahl
Sinn	Breite
Siöng-tschin	Hafen
Sippe	Inbegriff
Sire	Anrede
S.J.	Abkürzung
Sjédlez	Gouvernement
Skammonium	Milchsaft
Skandinavische Münzkonvention	Konvention
Sklavenküste	Landstrich
Sklaverei	Zustand
Skleritis	Entzündung
Skolopéndren	Ordnung
Skopolamin	Alkaloid
Skorpione	Ordnung
Skrofulariazeen	Pflanzenfamilie
Skyros	Nomos
s.l.	Abkürzung
Slawische Mythologie	Inbegriff
S.M.	Abkürzung
Smolénsk	Gouvernement
Sockel	Untersatz
Sodomie	Unzucht
Sofála	Landstrich
Sohl	Komitat
Solanazeen	Pflanzenfamilie
Solar	Sonne
Solarchemie	Untersuchung
Söller	Sonne
Solothurn	Kanton
Somnal	Lösung
Sondhaussche Linse	Linse
Sortimént	Sammlung
Soy	Gewebe
Sozial	Gesellschaft
Sozialíst	Anhänger
Sozialpolitik	Entwicklung
Sozinianer	Anhänger
Spaargebirge	Höhenzug
Spadizifloren	Ordnung
Spaltnapfschnecken	Familie
Spartivénto	Südspitze
Sparversicherung	Einrichtung
Speckkäfer	Familie
Spektabel	Titel
Spessart	Waldgebirge
Spezifikation	Aufzählung
Spezifische Mittel	Heilmittel
Sphärologie	Lehre
Sphärometer	Instrument
Spiegelmetall	Legierung
Spielmannsdichtung	Dichtung
Spillage	Verlust
Spina	Rückgrat
Spinalmeningitis	Entzündung
Spindel	Zylinder
Spinnentiere	Klasse
Spinner	Familie
Spinnerei	Arbeit
Spiritismus	Glaube
Spiritualismus	Ansicht
Spiritualität	Wesen
Spitzmäuse	Familie
Splanchna	Lehre
Spölalpen	Gruppe
Spondylus	Mehrzahl
Sporangium	Behälter
Sporen	Mehrzahl
Sporengänse	Familie
Sporentierchen	Klasse
Spratzen	Eigenschaft
Springschwänze	Familie
Sprotte	Fisch
Sprühfleckenkrankheit	Krankheit
Srihatta	Distrikt
Staatsministerium	Gesamtheit
Staatsrecht	Inbegriff
Staatsschulden	Summe
Staatsservitut	Beschränkung
Staatssozialismus	Richtung
Stabilität	Bestreben
Stabshautboist	Leiter
Stachelhäuter	Kreis
Stadtmission	Organisation
Stadtrecht	Recht
Stahlstich	Vervielfältigung
Stammeln	Unvermögen
Stampillen	Stempel
Stänker	Iltis
Stanzer Tal	Hochtal
Staphylitis	Entzündung
Stare	Familie
Stärkende Mittel	Mittel
Stater	Elektron
Statiös	Staat
Statisch	Statik
Statistische Gebühr	Abgabe
Stativ	Vorrichtung
Stauen	Beladen
Stáwropol	Gouvernement
Stechmücken	Familie
Stechrochen	Familie
Steigerwald	Waldgebirge
Steißhühner	Familie
Stelzenläufer	Gruppe
Stemma	Mehrzahl
Stempel	Werkzeug
Stempelschneidekunst	Kunst
Steppen-Generalgouvernement	Verwaltungsgebiet
Sterbeziffer	Verhältnis
Sterblingswolle	Wolle
Stereochemie	Lehre
Stereotypie	Verfahren
Sterling	Pfund
Sternalgie	Schmerz
Sternanis	Frucht
Sterntag	Zeitraum
Sternwarte	Gebäude
Steuerkontingent	Betrag
Steuermannskunst	Kenntnis
Stichbogen	Bogen
Stickerei	Verzierung
Stickmaschine	Einrichtung
Stiefverwandtschaft	Verhältnis
Stift	Mehrzahl
Stil	Kunst
Stimmritzenkrampf	Asthma
Stinkvogel	Bezeichnung
Stinkwiesel	Iltis
Stipes	Mehrzahl
Stock	Mehrzahl
Stockkrankheit	Wurmkrankheit
Stockmaß	Instrument
Stoffwechsel	Gesamtheit
Stoïzismus	Lehre
Stoma	Mehrzahl
Stomatika	Entzündung
Störche	Ordnung
Storchschnabel	Instrument
Stormarn	Kreis
Stoß	Wechselwirkung
Stottern	Unvermögen
Strafprozeß	Inbegriff
Strafrecht	Gesamtheit
Strahlkrebs	Erkrankung
Stratigraphie	Lehre
Stratus	Wolkenform
Streichen	Richtung
Strelasund	Meerenge
Streudüse	Vorrichtung
Stromdichte	Verhältnis
Stromkarten	Unterart
Strommesser	Instrument
Stromstärke	Stärke
Stromwender	Vorrichtung
Strudelwürmer	Ordnung
Struggle for life	Kampf
Stubaital	Hochtal
Stud.	Abkürzung
Stummheit	Unvermögen
Stundenwinkel	Winkel
Stundung	Verzicht
Stutzkäfer	Familie
Stygisch	Unterwelt
Subrogation	Einsetzung
Subsistieren	Bestand
Sucre	Geldeinheit
Sudan	Handelsbezeichnung
Südbahn	Gruppe
Südostinseln	Bezeichnung
Suëskanal	Kanal
Suggestibilität	Empfänglichkeit
Suggestion	Erweckung
Sujet	Vorwurf
Sulabai	Bucht
Suleimangebirge	Grenzgebirge
Sultân	Titel
umadija	Bergland
Sumbulwurzel	Wurzel
Sümeg	Komitat
Sumer	Reich
Summus episcopus	Bezeichnung
Sumpfschnecken	Familie
Sund	Meerenge
Sundastraße	Meerenge
Superarbitrium	Entscheidung
Supranaturalismus	Glaube
Sura	Abschnitt
Surettahorn	Bergstock
Surplus	Überschuß
Sus	Schwein
Susserin	Serum
Süßwasserschnecken	Familie
Suwali	Hafen
Suwálki	Gouvernement
s.v.p.	Abkürzung
SW.	Abkürzung
Swalli	Hafen
Symbolik	Lehre
Syndikus	Vertreter
Synergismus	Lehre
Synkretismus	Bestreben
Syntágma	Sammlung
Syntáktisch	Syntax
Syr-darja-Gebiet	Gebiet
Syrmien	Komitat
Systematik	Kunst
Szabolcs	Komitat
Szatmár	Komitat
Szene	Schaubühne
Szilágy	Komitat
Szolnok-Doboka	Komitat
Tabora	Station
Tachometer	Instrument
Tafeldruck	Druck
Tafelfichte	Gipfel
Tag	Zeitraum
Taille	Schnitt
Taitai	Hafenplatz
Takt	Feinheit
Táktik	Lehre
Talcahuano	Kriegshafen
Ta-lien-wan	Bucht
Talisch	Gebirgskette
Tamaulipas	Küstenstaat
Tambów	Gouvernement
tan	Abkürzung
tang	Abkürzung
Tange	Bezeichnung
Tangentometer	Instrument
Tangetet	Hafen
Tanosal	Mittel
Tantieme	Gewinnanteil
Tanzfliegen	Familie
Tanzkunst	Kunst
Tara	Gewicht
Targum	Mehrzahl
Tarimbecken	Gebiet
Taßißudon	Residenz
Tatarenschlacht	Schlacht
Tätowieren	Körperoberfläche
Tattersall	Anstalt
Taubenschießen	Frankreich
Taubheit	Unfähigkeit
Taucher	Ordnung
Tauern	Kette
Taufe	Sakrament
Taumelkäfer	Familie
Taurien	Gouvernement
Taus	Blatt
Tautologie	Wiederholung
Taxe	Schätzung
Téchnik	Lehre
Technikum	Vereinigung
Tedschurabai	Bucht
Teffîr	Wissenschaft
Tegel	Benennung
Tehl	Gewicht
Teilmaschine	Vorrichtung
Tekes	Oberlauf
Tektologie	Lehre
Tektonik	Kunst
Telegraphisches Sehen	Übertragung
Telepathie	Vermögen
Teleskop	Lehre
Tembo	Mehrzahl
Tembuland	Distrikt
Tempe	Schönheit
Temperamént	Gemütsart
Temperaturkurve	Linie
Tempora	Mehrzahl
Tenalgie	Schmerz
Tendénz	Streben
Tenésmus	Krampf
Tenga	Geldeinheit
Tennengebirge	Gruppe
Tenuis	Mehrzahl
Teratogenie	Entstehung
Terminologie	Inbegriff
Terminrechnung	Berechnung
Ternströmiazeen	Pflanzenfamilie
Terrain	Gestaltung
Territion	Bedrohung
Territorialität	Ansicht
Tesseralsystem	Kristallsystem
Tessin	Kanton
Tessiner Alpen	Gruppe
Testierfreiheit	Befugnis
Testimonium	Zeugnis
Tete	Spitze
Tetraëteris	Zeitraum
Teuerdank	Titel
Teufe	Schacht
Teufelsbrücke	Brücke
Texcoco	Salzsee
Text	Inhalt
T. F.	Feuermal
tg	Abkürzung
Tham-sui	Hafen
Than-schui	Hafen
Thaumatologie	Lehre
Theïst	Anhänger
Themata	Mehrzahl
Therapie	Lehre
Thérmik	Lehre
Thermochemie	Lehre
Thermometrie	Anwendung
Thermopylä	Engpaß
Thiophen	Wasserstoff
Thrombose	Gerinnung
Thronfolge	Eintritt
Thurgau	Kanton
Thüringer Pforte	Engpaß
Thyreoidektomie	Entfernung
Thyreoiditis	Entzündung
Thyreotomie	Spaltung
Thysanuren	Ordnung
Ticul	Grabstätte
Tiefbau	Gesamtheit
Tiefdruck	Druck
Tiefenhafen	Hafenplatz
Tiefkolonne	Aufstellung
Tierchemie	Lehre
Tierdienst	Verehrung
Tiergeographie	Wissenschaft
Tiergeographie	Zweig
Tierische Elektrizität	Gesamtheit
Tiermilben	Familie
Tierpsychologie	Zweig
Tierreich	Gesamtheit
Tiersage	Kreis
Tiflis	Gouvernement
Timpano	Mehrheit
Tirefond	Instrument
Tiro	Mehrzahl
Titlis	Bergstock
Tlaxcála	Staat
Tmesis	Trennung
Tod	Aufhören
Todeserklärung	Ausspruch
Tödi	Gebirgsstock
Tohuwabohu	Bezeichnung
Tonart	Anwendung
Tongeschlechter	Charakter
Tonleiter	Folge
Tonnenschnecken	Familie
Tonnlage	Fallen
Tonsur	Platte
Tonsystem	Darstellung
Top-weight	Gewicht
Toreutik	Kunst
Tories	Mehrzahl
Torontál	Komitat
Torresstraße	Meerenge
Torso	Rumpf
Torula	Gruppe
Tößuh	Längenmaß
Tote Hand	Bezeichnung
Totenvogel	Bezeichnung
Totes Gebirge	Gebirgsstock
Toxikämie	Aufnahme
Toxikologie	Lehre
Traberkrankheit	Nervenkrankheit
Tracheiden	Wasser
Tracheitis	Katarrh
Tracheobronchitis	Katarrh
Tracht	Gewände
Trafalgar	Vorgebirge
Tragik	Gesamtwirkung
Tragisch	Tragödie
Tragödie	Gattung
Trakt	Ausdehnung
Trama	Einschlag
Transkeidistrikt	Distrikt
Transplantation	Ersetzung
Trappen	Familie
Traum	Erzeugnis
Traunstein	Felsgipfel
Treckfahrtskanal	Kanal
Triakontere	Schiff
Tribometer	Vorrichtung
Tribulaun	Gipfel
Tribut	Abgabe
Trichophyton	Ursache
Trichotracheliden	Familie
Triforium	Arkade
Trikot	Wolle
Trimmen	Schiffsladung
Trinkgold	Bezeichnung
Trinkitat	Hafenplatz
Trippstein	Gipfel
Tripura	Distrikt
Tristien	Titel
Trochoceras	Gattung
Trockenfäule	Krankheit
Trogons	Familie
Troika	Wagen
Trommeltaube	Spielart
Trompetenschnecken	Familie
Tropäolazeen	Pflanzenfamilie
Troparion	Bezeichnung
Trophologie	Lehre
Trophoneurose	Ernährungsstörung
Tropikvögel	Familie
Trosse	Bezeichnung
Trüffel	Fruchtkörper
Trugratten	Familie
Trupiale	Familie
t.s.	Abkürzung
Tsa-tschu	Oberlauf
Tschagosinseln	Dependenz
Tschany	Salzsee
Tscheljuskin	Spitze
Tschernígow	Gouvernement
Tscheschme	Hafenplatz
Tschéskaja Gubá	Bucht
Tschinde	Hafen
Tschiribiri	Zweig
Tschitral	Gebiet
Tschusaninseln	Gruppe
Tsjusaninseln	Gruppe
Tubuliflorae	Unterfamilie
Tula	Gouvernement
Türkische Bagdette	Rasse
Turksinseln	Gruppe
Turnkunst	Betreibung
Turócz	Komitat
Tussoo	Längenmaß
Tuxer Tonschiefergebirge	Gruppe
Twer	Gouvernement
Typhazeen	Pflanzenfamilie
Typolithographie	Druck
Typometer	Meßinstrument
Ubangi	Mittellauf
Überfallsrecht	Recht
Überfracht	Gebühr
Überlandpost	Briefpost
Übersetzungsrecht	Ausfluß
Übertretung	Klasse
Üble Nachrede	Behauptung
Ubychen	Stamm
Uchapara	Strom
Udvarhely	Komitat
Uëba	Hohlmaß
Ufá	Gouvernement
Uferfliegen	Familie
Ugocsa	Komitat
Uiba	Hohlmaß
U.L.F.	Abkürzung
Ult.	Abkürzung
Ultima ratio regum	Mittel
Ultramarin	Verbindung
ü.M.	Abkürzung
Umbelliferen	Pflanzenfamilie
Umberfische	Familie
Undurchdringlichkeit	Eigenschaft
Unfruchtbarkeit	Unfähigkeit
Unfug	Störung
Ung	Komitat
Ungarische Sprache	Sprache
Uniformismus	Streben
Unionisten	Anhänger
Unitarier	Bezeichnung
Universalismus	Streben
Unlauterer Wettbewerb	Bezeichnung
Unterelsaß	Bezirk
Unterweißenburg	Komitat
Unvordenklichkeit	Zustand
Unz	Mittellauf
Urálsk	Gebiet
Uranolatrie	Verehrung
Urbarium	Grund
Urethra	Entzündung
Urheberrecht	Recht
Uri	Strom
Uribante	Oberlauf
Uri-Rothstock	Gipfel
Urkundenfälschung	Mißbrauch
Urningsliebe	Trieb
Urocele	Anschwellung
Urogenitalsystem	Gesamtheit
Urologie	Lehre
Uroskopie	Untersuchung
Urtikazeen	Pflanzenfamilie
U.S.	Abkürzung
Usindja	Gebiet
Uso	Wechsel
Usumbura	Station
Usurpation	Anmaßung
Ütliberg	Gipfel
Utrikulariazeen	Pflanzenfamilie
Uvula	Zäpfchen
Va.	Abkürzung
Vademekum	Titel
Vaginaten	Gruppe
Vakziniazeen	Pflanzenfamilie
Vâlcea	Kreis
Valdorf	Bauerschaft
Valvation	Schätzung
Van	Herkunft
Vanillin	Stoff
Vanitas vanitatum!	Eitelkeit
Vanity fair	Titel
Vaporimeter	Instrument
Vara	Längenmaß
Variolae	Pocken
Vaterschaft	Verhältnis
V.C.	Abkürzung
Vedische Religion	Phase
Veen	Plateau
Vegetation	Leben
Velarium	Decke
Venediger	Gipfel
Venezianer Alpen	Gruppe
Venezien	Gebiet
Veni	Strom
Veni, vidi, vici	Ausspruch
Ventilation	Erneuerung
Ventôse	Monat
Verba	Mehrzahl
Verbenazeen	Pflanzenfamilie
Verbum	Mehrzahl
Verdíkt	Ausspruch
Verfall	Zeitpunkt
Verfassung	Summe
Verflüssigung	Überführung
Verfolgungswahn	Symptom
Vergasung	Überführung
Verifizieren	Richtigkeit
Verlagsrecht	Berechtigung
Verm	Abkürzung
Vernagtferner	Gletscher
Verschwörung	Verbindung
Versicherungswesen	Gesamtheit
vert.	Abkürzung
Verwandtschaft	Verbindung
Veterinärpolizei	Gesamtheit
Viamala	Engpaß
Vicarius	Selbstbezeichnung
Vicentinische Alpen	Gruppe
Vielflosser	Familie
Vielzähner	Familie
Vierkant	Richtung
Vierkiemer	Ordnung
Vieux Saxe	Bezeichnung
Vilen	Einzahl
Villanovakultur	Nekropole
Violétt	Mischung
Vipern	Familie
Virovititz	Komitat
Virulént	Fähigkeit
Vis-a-vis	Gegenüber
Viß	Gewicht
Viszeral	Eingeweide
Viti-i-loma	Gruppe
Vitriol	Bezeichnung
Vivarium	Behältnis
Vlies	Schaffell
Vögel	Klasse
Vogeldunst	Schrot
Vogtländische Schweiz	Umgebung
Vokalisation	Aussprache
Volapük	Bezeichnung
Völkerschlacht	Bezeichnung
Völkerwanderung	Bewegung
Volkssouveränität	Prinzip
Volksvertretung	Vertretung
Vollkaufmann	Bezeichnung
Vollziehende Gewalt	Staatsgewalt
Voltameter	Instrument
Vorderkiemer	Ordnung
Vorflut	Entwässerung
Vorkaufsrecht	Vorrecht
Voruntersuchung	Verfahren
Vorzugsrecht	Recht
Vt.	Abkürzung
Vuélta Abajo	Distrikt
Vulkanisten	Anhänger
Waadt	Kanton
Wachsbildnerei	Kunst
Wachstum	Fähigkeit
Wâd el-Kebîr	Unterlauf
Waesland	Landstrich
Wa-fan-kou	Eisenbahnstation
Waffenstillstand	Einstellung
Wagenkuppelung	Verbindung
Wahhâbiten	Anhänger
Wakuf	Mehrzahl
Waldfeldbau	Verbindung
Waldhühner	Familie
Wallaby	Bezeichnung
Wallis	Kanton
Wallwitzhafen	Hafen
Waltiere	Ordnung
Walzenspinnen	Ordnung
Walzenstuhl	Gestell
Wanderleber	Senkung
Wandermilz	Verlagerung
Wanderniere	Lageveränderung
Wanne	Kolonie
Wanzen	Unterordnung
Waräger	Bezeichnung
Warasdin	Komitat
Warenkunde	Lehre
Warenkunde	Kennzeichen
Wärme	Ursache
Wärmeäquator	Linie
Wartburgkrieg	Sängerkrieg
Wartepflicht	Beschränkung
Washington	Staat
Wasserbruch	Ansammlung
Wasserdicht	Eigenschaft
Wasserfarben	Gummi
Wasserflöhe	Unterordnung
Wassergenossenschaften	Vereinigung
Wasserjungfern	Familie
Wasserkies	Markasit
Wasserläufer	Gruppe
Wassermessung	Ermittlung
Wasserrecht	Inbegriff
Wasserschöpfapparat	Instrument
Wassertreter	Gruppe
Wasserversorgung	Inbegriff
Wasserwage	Instrument
Watt	Einheit
Watzmann	Bergspitze
WE.	Abkürzung
Wechselprozeß	Verfahren
Wechselprozeß	Abart
Wechselrecht	Inbegriff
Wechselstrenge	Strenge
Wechselwinkel	Winkel
Wegwespen	Familie
Wehrvögel	Familie
Weichflosser	Ordnung
Weichsel-Haff-Kanal	Verbindung
Weichtierähnliche	Kreis
Weichtiere	Kreis
Weihen	Unterfamilie
Weihnachtsspiele	Gattung
Weinsteuer	Unterart
Weiß	Farbe
Weiße Woche	Woche
Weißsieden	Verfahren
Weißtannental	Hochtal
Weitsichtigkeit	Zustand
Wellandkanal	Kanal
Wellenberuhigung	Anwendung
Wepsen	Zweig
Werbung	Ersatz
Werg	Abgang
Wert	Bedeutung
Wertigkeit	Vermögen
Westerwald	Plateau
Westvirginia	Staat
Wetterglas	Bezeichnung
Wetterprognose	Vorherbestimmung
Wetterschießen	Beeinflussung
Wettersteingebirge	Gruppe
W.E.Z.	Abkürzung
Whist	Kartenspiel
Whitehall	Straße
Widensoler Kanal	Teilstrecke
Widerlage	Vermögen
Widersetzlichkeit	Widerstand
Widersetzlichkeit	Widerstand
Wiedersicht	Wechsel
Wiesbachhorn	Gipfel
Wildbret	Fleisch
Wilddiebstahl	Beeinträchtigung
Wildgraf	Titel
Wilna	Gouvernement
Windrose	Scheibe
Windward Passage	Meerenge
Winkel	Unterschied
Winterschlaf	Lethargie
Wirbel	Knochen
Wirbelatome	Bezeichnung
Wirkungsgrad	Verhältnis
Wirtschaftsgeographie	Zweig
Wiß	Gewicht
Wissmannhafen	Hafenplatz
Witebsk	Gouvernement
Witwatersrandgebirge	Hügelzug
Witwenvogel	Afrika
Wjatka	Gouvernement
Wladímir	Gouvernement
W.O.	Abkürzung
Woche	Zeitabschnitt
Wohnungsfrage	Frage
Wolgahöhen	Hügelland
Wolgasteppe	Steppengebiet
Wolkenburg	Gipfel
Wollmesser	Instrument
Wólogda	Gouvernement
Wölzer Alpen	Gruppe
Worónesh	Gouvernement
Wort	Verbindung
Wortblindheit	Unvermögen
Wringmaschine	Vorrichtung
Wühlmäuse	Familie
Wundernuß Salomos	Frucht
Wurf	Bewegung
Wurfmäuse	Familie
Würger	Familie
Wurmbeulen	Knoten
Würmer	Kreis
Wurmfraß	Wirkung
Wurmschlangen	Familie
Wurst	Speise
Wurzelbohrer	Unterfamilie
Wurzelfüßer	Ordnung
W.Va.	Abkürzung
Xanthelásma	Hautkrankheit
Yambô	Hafenplatz
Yellow metal	Legierung
Yohimbin	Alkaloid
Yukon	Strom
Yuruari	Territorium
Zackenschwärmer	Gruppe
Zahlensystem	Darstellung
Zahnarme	Ordnung
Zahnen der Kinder	Entwicklung
Zahnfüllung	Ersatz
Zahnkarpfen	Familie
Zahnschnäbler	Gruppe
Zala	Komitat
Zambesi	Strom
Zancara	Oberlauf
z.D.	Abkürzung
Zebaoth	Mehrzahl
Zecken	Familie
Zehnt	Abgabe
Zeisige	Gruppe
Zeitdifferenz	Unterschied
Zeiteinheit	Sekunde
Zeitsinn	Fähigkeit
Zellgewebswassersucht	Krankheit
Zend	Sprache
Zenitdistanz	Bogen
Zentralbewegung	Bewegung
Zentralisation	Vereinigung
Zentrieren	Mittellinie
Zeolithe	Gruppe
Zerteilende Mittel	Heilmittel
Zeugungsvermögen	Fähigkeit
Zichoriazeen	Unterfamilie
Zillertaler Alpen	Gruppe
Zinkblüte	Mineral
Zinkographie	Anwendung
Zinkpuder	Gemisch
Zinsenversicherung	Zweig
Zinsrechnung	Berechnung
Zips	Komitat
Zirkulieren	Runde
Zistérne	Behälter
Zitteraale	Familie
Zivilstand	Gesamtheit
Zivilversorgung	Anstellung
Zodiakus	Zeichen
Zollfeld	Ebene
Zollregal	Recht
Zollstrafrecht	Gesamtheit
Zollverein	Vereinigung
Zoologie	Wissenschaft
Zoonomie	Lehre
Zoopathologie	Lehre
Zootomie	Anatomie
Zuffenhausen	Industriedorf
Zug	Kanton
Zugspitz	Baden
Zulia	Staat
Zündungen	Mittel
Zungenwürmer	Ordnung
Zurechnungsfähigkeit	Fähigkeit
Zurückbehaltungsrecht	Recht
Zweikiemer	Ordnung
Zwerghirsche	Familie
Zwerghühner	Zwergform
Zwergkäfer	Familie
Zwergschlangen	Indien
Zwergwespen	Familie
Zwetschen	Gruppe
Zygophyllazeen	Pflanzenfamilie
Zykadeen	Pflanzenfamilie
Zyklen	Mehrzahl
Zyklitis	Entzündung
Zyklometrie	Inbegriff
Zylindrieren	Bearbeitung
Zymologie	Lehre
Zytoblást	Zellkern
