Aalmutter	Seefisch
Abdest	Waschung
Abdikation	Niederlegung
Abfindung	Tilgung
Ablaktation	Entwöhnung
Ablaß	Erlaß
Abschichtung	Absonderung
Abschuppung	Abstoßung
Absorptiometer	Apparat
Acanthosicyos horrida	Strauch
Achen	Abfluß
Achromasie	Ablenkung
Achtender	Hirsch
Ächtung	Verhängung
Adelsprädikat	Präposition
Adjoint	Stellvertreter
Adler	Sternbild
Adlerdollar	Beiname
Adlervitriol	Salzburger
Adressánt	Aussteller
Adullamiten	Spitzname
Aërophor	Apparat
Afrikanischer Krieg	Krieg
Afrikanischer Stern	Orden
Aftermiete	Wiedervermietung
Agasias	Bildhauer
Agathokles	Tyrann
Agaw	Ureinwohner
Agiotage	Spekulation
Agnoeten	Partei
Agua	Vulkan
Ägyptolog	Forscher
Ahlbeere	Johannisbeere
Akanthopterygier	Stachelflosser
Akhissar	Festung
Akis	Geliebter
Akiurgie	Chirurgie
Akkusat	Angeklagte
Akotyledonen	Pflanzen
Aktuar	Beamter
Akupressur	Blutstillung
Akupunktur	Heilverfahren
Akzént	Hervorhebung
Akzise	Steuer
Albemarlesund	Busen
Albreda	Handelsplatz
Albula	Nebenfluß
Alcide	Beiname
Alea jacta est	Würfel
Aleatorisch	Würfelspiel
Alektryomachie	Wahrsagung
Aleurometer	Apparat
Alexandrinischer Krieg	Krieg
Alexandrópol	Festung
Alexis	Pseudonym
Algoabai	Meerbusen
Alkalimetalle	Rubidium
Alkamenes	Schüler
Alkide	Beiname
Allada	Handelsplatz
Allasch	Fenchel
Alleghany	Quellfluß
Alliánz	Bündnis
Almenrausch	Alpenrose
Almonte	Handelsplatz
Alt	Nebenfluß
Altenbergen	Pfarrdorf
Altenstein	Lustschloß
Altesse	Ehrentitel
Althing	Volksvertretung
Altscherbitz	Irrenanstalt
Amaler	Herrschergeschlecht
Amaltheia	Ziege
Amaurose	Schwarzer
Ambiorix	Fürst
Amictus	Schultertuch
Amis	Pfaffe
Amnion	Eihaut
Amor vincit omnia	Liebe
Amraoti	Handelsplatz
Amras	Schloß
Amulios	Scheidemünze
Amygdaleen	Unterabteilung
Anabasis	Feldzug
Analgesie	Aufhebung
Ananias	Verfolger
Anathem	Weihgeschenk
Anbetung des heiligen Sakraments	Orden
Ancyra	Angora
Anecho	Handelsplatz
Aneho	Handelsplatz
Angelfischerei	Fangen
Angina	Bräune
Anglíst	Kenner
Anglomanie	Vorliebe
Angrecum fragrans	Orchidee
Angurie	Wassermelone
Anlasser	Apparat
Antiabolitionisten	Gegner
Antichrese	Vertrag
Antinomismus	Verwerfung
Antipater	Feldherr
Antiphon	Verfasser
Antisana	Vulkan
Antisemit	Gegner
Antisépsis	Wundbehandlung
Apfel	Obstbaum
Apis	Honigbiene
Apokalyptiker	Verfasser
Apollyon	Verderber
Apologetik	Verteidigung
Apologie	Verteidigungsrede
Apoplexie	Zerreißung
Apostata	Abtrünnige
Apostata	Beiname
Apostolische Majestät	Ehrentitel
Appellation	Anrufung
Applaudieren	Beifall
Applikatur	Fingersatz
Aquarellfarbendruck	Reproduktionsverfahren
Aquarellmalerei	Malerei
Arabát	Landzunge
Arabíst	Kenner
Arachnologie	Naturgeschichte
Arbeitslohn	Vergütung
Arbit	Abendgebet
Archaïsmus	Gebrauch
Archäolog	Erforscher
Arenenberg	Schloß
Ares	Kriegsgott
Arethusa	Quelle
Argun	Quellfluß
Arillus	Samenmantel
Ariovíst	Heerführer
Arisch	Arier
Aromatische Tinktur	Tinktur
Aromunen	Abteilung
Arrénde	Hingabe
Arrha	Anzahlung
Arsenikalien	Arsen
Artabazus	Feldherr
Artaphérnes	Neffe
Artemisia	Fürstin
Artium liberalium magister	Lehrer
Aruscha	Militärposten
Arvalische Brüder	Kollegium
Aschenbrödel	Heldin
Aschermittwoch	Mittwoch
Asir	Gebirgslandschaft
Asklepiades	Freund
Aspe	Zitterpappel
Asséssor	Beisitzer
Assibilation	Verwandlung
Associé	Teilhaber
Astrallicht	Lichtschimmer
Astrolabebai	Einbuchtung
Astronomische Zentralstelle	Kieler
Asyndeton	Zusammenstellung
Atemgeräusch	Geräusch
Athanarich	Führer
Atheïsmus	Leugnen
Athenäum	Tempel
Atitlán	Vulkan
Atrek	Grenzfluß
Atthis	Dialekt
Aub	Nebenfluß
Aloys Auer	Ritter
Auferstehung	Neubelebung
Aufprotzen	Geschütz
Aufruhr	Zusammenrottung
Aufwiegelung	Aufforderung
Auge	Sehorgan
Auktion	Verkauf
Ausfuhrprämien	Gewerbezweig
Aushängebogen	Druckbogen
Auslobung	Bekanntmachung
Auspizien	Ausschau
Ausspielgeschäft	Veräußerung
Ausverkauf	Verkauf
Auswanderung	Übersiedlung
Autoinfektion	Verschleppung
Automedon	Wagenlenker
Avers	Hochgebirgstal
Aveyron	Nebenfluß
Avoirdupois	Beiname
Axenberg	Bergvorsprung
Aymará	Indianervolk
Azel	Elster
Azhar	Moschee
Azteken	Bevölkerung
Bache	Wildsau
Badinguet	Spottname
Badioten	Bewohner
Bahawalpur	Vasallenstaat
Baidak	Flußschiff
Bairaktár	Ehrenname
Bakaïrí	Indianerstamm
Balancierpresse	Maschine
Balken	Beackerung
Ballétt	Schaustellung
Ballistische Linie	Flugbahn
Balsamocárpum brevifolium	Dornstrauch
Bambuk	Berglandschaft
Banana	Handelsplatz
Banz	Schloß
Barbakane	Außenwerk
Barbarossa	Beiname
Barden	Dichter
Bärenfenchel	Bärwurz
Bark	Segelschiff
Bar Kochba	Urheber
Barnim	Freifrau
Baronie	Besitzung
Barton	Landmädchen
Barûch	Gehilfe
Basch	Befehlshaber
Baschtarde	Galeere
Basoche	Gilde
Basselissestuhl	Webstuhl
Bassiafette	Fette
Bastide	Landhaus
Bästling	Hanfpflanze
Bataillon	Fußtruppe
Batanga	Küstenlandschaft
Bâtonnier	Obermeister
Batterie	Zusammenstellung
Bäuchen	Behandlung
Bauchflosser	Abteilung
Bauernlegen	Einziehung
Bauges	Kalkplateau
Baummörder	Baumwürger
Baumscharbe	Kormoran
Baumwollspinnerei	Verarbeitung
Bavon	Schutzpatron
Beberbeck	Vorwerk
Beckmesser	Nürnberger
Bede	Pseudonym
Bedlam	Irrenhaus
Beelzebub	Gottheit
Befähigungsnachweis	Nachweis
Begna	Quellfluß
Beichtvater	Geistliche
Belisar	Feldherr
Bellum	Krieg
Bereicherungsklage	Klage
Berengar	Vorsteher
Berg	Pseudonym
Bergakademie	Lehranstalt
Bergbock	Steinbock
Berggrün	Wasserfarbe
Bergstraße	Kunststraße
Berilldruck	Herstellung
Berintho	Pseudonym
Berliner Handelsgesellschaft	Kommanditgesellschaft
Beschränkte Haftung	Haftung
Beschtau	Berggruppe
Besemschon	Abzug
Besnyö	Kapuzinerkloster
Bessus	Satrap
Bethlem	Londoner
Betrug	Vergehen
Beweis	Darlegung
Beyer	Basaltkuppe
Bharatpur	Vasallenstaat
Bhavabhuti	Verfasser
Biberindianer	Indianerstamm
Bibi	Hütchen
Bibliographisches Institut Meyer	Verlagsbuchhandlung
Bibliothekar	Verwalter
Bibliothekographie	Beschreibung
Biblische Altertumskunde	Hilfswissenschaft
Biceps	Beiname
Bichon	Bologneser
Biddle	Stifter
Bidouze	Nebenfluß
Biebricher Scharlach	Seide
Biene	Sternbild
Bienenvogel	Bienenfresser
Bierwage	Aräometer
Biesterfeld	Jagdschloß
Bièvre	Marquis
Big Black River	Nebenfluß
Bihar	Unterabteilung
Bihatsch	Festung
Bildende Künste	Baukunst
Bildende Künste	Bildhauerkunst
Biliar	Galle
Bin	Befehlshaber
Binnenschiffahrt	Fahrt
Biographie	Verfasser
Birne	Obstbaum
Bismutum	Wismut
Bistritza	Nebenfluß
Blackrock	Seebad
Blackwood & Sons	Verlagsbuchhandlung
Blake	Kupferstecher
Blanco	Präsident
Blankenberghe	Seebad
Blättermagen	Abteilung
Blaubeere	Heidelbeere
Blaufalke	Wanderfalke
Blaustrumpf	Spottname
Blegno	Nebenfluß
Bleigießerei	Herstellung
Bleiweiß	Plumbum
Blenio	Nebenfluß
Blindfisch	Schleimaal
Blutbrechen	Erguß
Blutfink	Buchfink
Blutlaus	Blattlaus
Bö	Hagel
Bob	Spitzname
Bobo	Possenreißer
Bocksattel	Sattel
Bocskay	Fürst
Bodrog	Nebenfluß
Boëdromios	Beiname
Bogardusmühle	Mühle
Bogenbrücke	Eisenbrücke
Böhme	Theosoph
Bohnenkönigsfest	Familienfest
Bohrmaschine	Maschine
Boina	Abzeichen
Boleslawita	Pseudonym
Bolivia	Republik
Bomba	Spottname
Bombarde	Geschütz
Bombykometer	Tabelle
Bonifacius	Apostel
Bonifaciusbrunnen	Solquelle
Boni homines	Beiname
Bonzen	Priester
Bootes	Sternbild
Bootsrolle	Verteilung
Borsigwerk	Hüttenwerk
Borstenwürmer	Unterklasse
Borussia	Vorliebe
Bosniaken	Bewohner
Botallo	Leibarzt
Botanybai	Meerbusen
Botenlauben	Burgruine
Musikalienhandlung in Berlin Bote & Bock	Musikalienhandlung
Boufflers	Marquis
Bourgeoisie	Bürgerschaft
Bournemouth	Seebad
Bourrée	Gavotte
Bourtanger Moor	Hochmoor
Boz	Schriftstellername
Brangäne	Begleiterin
Braun & Schneider	Verlagsbuchhandlung
Bravissimo	Superlativ
Brechmaschine	Maschine
Brennglas	Pseudonym
Brennus	Führer
Breviarium	Wirtschaftsbuch
Brin	Schöpfer
Brisling	Sprotte
Broadstairs	Seebad
Bromios	Beiname
Brosamer	Holzschneider
Brown	Stifter
Browne	Reichsgraf
Broye	Zufluß
Broyon	Läufer
Brückenkopf	Befestigungswerk
Bruieren	Zeuge
Bruyèreholz	Wurzelholz
Buch	Blättermagen
Buch der Bücher	Bibel
Buchmagen	Blättermagen
Büchsflinte	Gewehr
Bucken	Springen
Buddha	Stifter
Buffo	Sänger
Bumerang	Wurfwaffe
Bundestag	Versammlung
Bunkershill	Hügel
Bun-raj	Bastfaser
Burda	Mantel
Burdschiten	Dynastie
Buren	Bevölkerung
Büren	Ahnherr
Bürgenstock	Kurhaus
Bürgermeister	Vorsitzender
Burnham	Seebad
Bürstenabzug	Korrekturabzug
Büßling	Hanfpflanze
Butler	Oberst
Buto	Pflegemutter
Butt	Flunder
Buzephalus	Lieblingspferd
Byr	Pseudonym
C	Buchstabe
Caballero	Schriftstellername
Cabalministerium	Spottname
Cachenez	Schal
Caffarelli	Palast
Cafuso	Mischling
Caisson	Kammer
Calasanza	Stifter
Calceus	Fußbekleidung
Calcio	Ballspiel
Caldarium	Badezimmer
Caliche	Chilesalpeter
Caelius mons	Hügel
Calumet	Friedenspfeife
Camaldoli	Mutterkloster
Camáuro	Mütze
Camerarius	Aufseher
Campbelliten	Sekte
Canadian River	Nebenfluß
Canaletto	Beiname
Candiot	Einwohner
Canino	Fürst
Capite censi	Bürger
Capot	Regenmantel
Capra	Ziege
Caput Medusae	Erweiterung
Caquetá	Quellfluß
Cardona	Festung
Carey	Komponist
Carpaccio	Maler
Carpentariagolf	Meerbusen
Cärularius	Patriarch
Cassis	Likör
Casti	Hofpoet
Casula	Meßgewand
Catulus	Beiname
Cauca	Nebenfluß
Cavourkanal	Bewässerungskanal
Cayuga	Indianerstamm
Cedar Creek	Nebenfluß
Cédille	Häkchen
Cembalíst	Spieler
Cenere	Bergrücken
Cepheus	Sternbild
Cerna	Nebenfluß
Cerographie	Gravierung
Cervin	Matterhorn
Cervus	Hirsch
Champlain	Binnensee
Charazeen	Abteilung
Charon	Fährmann
Chasan	Vorbeter
Châteaubriand	Vicomte
Chatsworth House	Schloß
Chesapeakebai	Busen
Chichimeca	Urbewohner
Chickahominy	Nebenfluß
Chickamauga	Nebenfluß
Chiers	Nebenfluß
Chiese	Nebenfluß
Chillon	Schloß
Chippewa	Nebenfluß
Chiquito	Indianerstamm
Chiton	Unterkleid
Chiwa	Chanat
Chlamys	Mantel
Chloë	Beiname
Choden	Bewohner
Chokieren	Anstoß
Choreographie	Aufzeichnung
Choriambus	Versfuß
Choripetalen	Abteilung
Chorrillos	Seebad
Christliche Kunst	Epoche
Christmonat	Dezember
Christwurz	Nieswurz
Chromoxylographie	Herstellung
Chroníst	Verfasser
Chronograph	Verfasser
Chronoskop	Apparat
Chútor	Landhaus
Cirrokumulus	Schäfchen
Cirrus	Locke
City	Bischof
Civitavecchia	Festung
Claremont	Lustschloß
Clarendon Press	Buchdruckerei
Clarke's River	Quellfluß
Coccinella	Marienkäfer
Coccyx	Steißbein
Comanches	Indianerstamm
Communeros	Partei
Conchos	Nebenfluß
Condominium	Miteigentum
Conjunctiva	Bindehaut
Consanguinei	Halbgeschwister
Coquelicot	Klatschmohn
Corcovado	Vulkan
Coriolanus	Beiname
Corrèze	Nebenfluß
Corubin	Handelsname
Corylus	Haselnußstrauch
Coseguina	Vulkan
Coucy	Kastellan
Coupure	Durchstich
Cowper	Anatom
Crampas	Ostseebad
Crassula	Pflanzen
Crassus	Zuname
Crofters	Kleinpächter
Crookes	Physiker
Croton River	Nebenfluß
Croupier	Gehilfe
Crow	Indianerstamm
Crozat	Marquis
Crucis	Mittwoch
Cucúllus	Kutte
Cumbal	Vulkan
Cupressus	Zypresse
Cutis	Lederhaut
Cuza	Fürst
Cyane	Kornblume
Cydonia	Quittenbaum
Cyma	Trugdolde
Cyprische Erde	Handelsname
Czerny	Beiname
D	Buchstabe
Dachs	Raubtier
Dachshund	Hunderasse
Dakhani	Dialekt
Daktyliomantie	Wahrsagung
Daktylus	Versfuß
Dalekarlien	Gebirgslandschaft
Dalmatinische Literatur	Literatur
Dammersfeld	Bergkuppe
Damokles	Höfling
Dampfakkumulator	Apparat
Dampfbad	Einwirkung
Dampfkessel	Apparat
Dandin	Titelrolle
Dannemora	Kirchspiel
Danziger Bucht	Einbuchtung
Darling	Nebenfluß
Dataria	Abteilung
Daucus	Mohrrübe
Daulatabad	Felsenfestung
Daumont	Viergespann
D'Azeglio	Staatsmann
D. C. L.	Doktor
D. D.	Doktor
Deblockieren	Blockade
Decandria	Pflanzen
Decharge	Freisprechung
Décime	Zehnte
Deckoffizier	Dienstgrad
Décomte	Abzug
Defraudation	Veruntreuung
Degen	Seitengewehr
Dekabristen	Teilnehmer
Dekachórd	Musikinstrument
Dekastichon	Strophe
Dekatieren	Behandlung
Dekórt	Abzug
Dekumatische Äcker	Dreieck
Delilâ	Geliebte
Delphin	Sternbild
Demaskieren	Maske
Demeter	Gottheit
Demographie	Beschreibung
Demokritus	Pseudonym
Dender	Nebenfluß
Dendrologie	Naturgeschichte
Denk	Führer
Deotyma	Pseudonym
Depolarisation	Aufhebung
Deportation	Verbannung
Deputation	Abordnung
Derg	Erweiterung
Derogation	Aufhebung
De Spuches	Fürst
Destinatär	Empfänger
Deszendénten	Verwandte
Detektiv	Polizeibeamter
Détente	Nachlaß
Deterrition	Abschreckung
Deûle	Nebenfluß
Deutsch	Pseudonym
Deutsche Bank	Bankinstitut
Deutsche Ritter	Deutscher
Diabas	Eruptivgestein
Diabetometer	Apparat
Diagometer	Apparat
Diamagnetismus	Einwirkung
Diaphanometer	Apparat
Diaphanoskop	Apparat
Diaphyse	Mittelstück
Diaplasma	Salbung
Diaskeuást	Ordner
Dickfuß	Vogel
Diebstahl	Wegnahme
Dienstag	Wochentag
Dienstmiete	Vertrag
Dienstprämie	Prämie
Dietsch	Nürnberger
Diffalco	Abzug
Digamma	Buchstabe
Dikephalus	Mißgeburt
Dimbovita	Nebenfluß
Dinder	Nebenfluß
Dinglinger	Goldschmied
Diniz	Pseudonym
Diodorus	Presbyter
Dionysien	Feste
Dionysius	Schüler
Diorit	Eruptivgestein
Diptychon	Schreibtafel
Dira necessitas	Zitat
Diskónt	Abzug
Diskontogesellschaft	Kommanditgesellschaft
Diskos	Wurfscheibe
Dislokation	Verteilung
Dispensation	Entbindung
Dispersion	Zerlegung
Dithyrámbus	Beiname
Dito und Idem	Pseudonym
Diurnale	Gebetbuch
Dizeratenkalk	Kalkstein
Dodekarchie	Regierung
Dolerit	Eruptivgestein
Domestikation	Umwandlung
Dominica	Sonntag
Domkapitel	Kapitel
Dompropst	Propst
Donajec	Nebenfluß
Doppelbesteuerung	Besteuerung
Doppelbrechung	Zerlegung
Doyen	Älteste
Dózsa	Anführer
Drahtwurm	Larve
Drall	Windung
Dranmor	Pseudonym
Drau	Nebenfluß
Drehen	Zerspanung
Dreiherrenspitz	Alpengipfel
Dreizack	Speer
Dresdner Bank	Bankinstitut
Drilling	Jagdgewehr
Drogistenschule	Fachschule
Dromos	Wettlauf
Drossel	Luftröhre
Drücken	Arbeitsverfahren
Druiden	Priester
Druidenorden	Geheimbund
Druse	Hohlraum
Drusen	Völkerschaft
Drusus	Beiname
Dschenne	Handelsplatz
Dsjeja	Nebenfluß
Dulce et decorum est, pro patria mori	Zitat
Dulzinea	Geliebte
Dünamünde,	Festung
Dunoon	Seebad
Dunsinane	Hügel
Dunstdruck	Spannung
Duranametall	Aluminium
Dux	Befehlshaber
Dyveke	Geliebte
Ebel	Führer
Ebenzweier	Schloß
Echter	Fürstbischof
Ecrins	Barre
Ecuador	Republik
Eddystone	Felsengruppe
Eféndi	Ehrentitel
Egeria	Gemahlin
Ehrenlegion	Orden
Ehrlicher Makler	Zitat
Eibsee	Alpensee
Eichenkrone	Orden
Eider	Grenzfluß
Eidsvold	Kirchspiel
Eigentum ist Diebstahl	Zitat
Einbruchsdiebstahlsversicherung	Versicherung
Eindeckungen	Balken
Ejâlet	Statthalterschaft
Ekchymose	Austritt
Ekklesia	Volksversammlung
Eklipse	Verschwinden
Ektasie	Erweiterung
Eläometer	Aräometer
Elbe	Pseudonym
Elektrische Kapazität	Fassungsvermögen
Elektrisieren	Elektrizität
Elektrogravüre	Herstellung
Elektrolyse	Zerlegung
Elektrometallurgie	Gewinnung
Elephantine	Assuan
Elfkarleby	Kirchspiel
Eli	Priester
Eliot	Schriftstellername
Elite	Beste
El.... y	Pseudonym
Elysée	Palast
Elz	Nebenfluß
Emersion	Auftauchen
Empsychose	Eintreten
Empyromantie	Weissagung
Emser Depesche	Depesche
Endossiermaschine	Maschine
Engerling	Larve
Englischer Lobgesang	Lobgesang
Englisieren	Durchschneiden
Enosíchthon	Beiname
Entdeckung	Auffindung
Entenadler	Schreiadler
Entomostraken	Unterklasse
Entre-Côte	Rippenstück
Entrepot	Niederlage
Enyo	Begleiterin
Enzyklopädísten	Herausgeber
Eos	Göttin
Eos	Gemahlin
Epákten	Zahlen
Epaminóndas	Feldherr
Epárch	Statthalter
Epenthese	Einschalten
Ephraïmiten	Spottname
Epierreur	Maschine
Epimythium	Schlußrede
Epistola	Brief
Epistropheus	Halswirbel
Eppishusen	Meister
Erbkaiserliche	Partei
Erbtochter	Verwandte
Erbuntertan	Untertan
Erbunwürdigkeit	Verhalten
Erbvertrag	Vertrag
Erechtheion	Tempel
Eresburg	Grenzfestung
Erfindung	Auffindung
Ergograph	Apparat
Erinna	Freundin
Eriomys	Wollmaus
Ernährungstherapie	Benutzung
Erpressung	Vergehen
Ersatz	Ergänzung
Ersitzung	Erwerbung
Erzguß	Herstellung
E.S.	Meister
Escudero	Adliger
Espingole	Muskete
Eßlingen	Schulmeister
Esten	Bewohner
Estomihi	Sonntag
États généraux	Generalstaaten
Ethologie	Schilderung
Etretat	Seebad
Ettrickschäfer	Beiname
Eudokia	Gemahlin
Euergétes	Beiname
Eugippius	Verfasser
Euklides	Schüler
Eulen nach Athen tragen	Redensart
Eumaios	Sklave
Eunus	Sklave
Eupator	Beiname
Euphemismus	Umschreibung
Eurybiades	Führer
Eurydike	Gemahlin
Eutyches	Archimandrit
Evoe	Jubelruf
Evolena	Pfarrdorf
Ewige Richtung	Vertrag
Exartikulation	Ablösung
Exaudi	Sonntag
Exekution	Realisierung
Extra	Liber
Extravasat	Austritt
Exzellénz	Ehrentitel
Exzelsior	Komparativ
Eyjafjalla	Vulkan
Eyke von Repkow	Verfasser
Fähe	Weibchen
Falisker	Einwohner
Fallbach	Wasserfall
Familiendiebstahl	Diebstahl
Fanchon	Diminutiv
Farm	Landwirtschaft
Farne	Abteilung
Fassondrehbank	Drehbank
Fassonkognak	Nachahmung
Fasten	Enthaltung
Fäulnis	Zersetzung
Faure	Präsident
Febronius	Pseudonym
Februarrevolution	Revolution
Feldbereinigung	Neuordnung
Felddiebstahl	Diebstahl
Feldfriedensbruch	Gehen
Feldfriedensbruch	Reiten
Feldgemeinschaft	Gemeinbesitz
Feldläufer	Goldregenpfeifer
Feldstelze	Brachpieper
Felis	Katze
Felsenkrähe	Alpenkrähe
Felsensegler	Alpensegler
Fennomanen	Partei
Fenstersteuer	Besteuerung
Fère	Festung
Ferrotypie	Photographie
Fettblume	Dotterblume
Fettdrüse	Bürzeldrüse
Fettflechte	Flechte
Fettpflanzen	Pflanzen
Fetwa	Gutachten
Feuerwerkerei	Anfertigung
Fichtenhacker	Hakengimpel
Fiecht	Benediktinerabtei
Filagrámm	Wasserzeichen
Filatorium	Maschine
Finkenhabicht	Sperber
Finkmeise	Kohlmeise
Fischart	Dichter
Fischgeier	Seeadler
Fischläuse	Ruderfüßer
Fischzucht	Pflege
Fisettholz	Kernholz
Fixative	Kreide
Flachrennen	Wettrennen
Flachsspinnerei	Herstellung
Flagellaten	Geißeltierchen
Flaggschiff	Kriegsschiff
Flamininus	Beiname
Flammula	Standarte
Fleisch	Muskelmasse
Fliegenstein	Arsen
Flöte	Blasinstrument
Flötner	Holzschneider
Flottille	Verband
Flügelfrucht	Schließfrucht
Flußotter	Fischotter
Flutometer	Apparat
Fluxion	Strömung
Folz	Meistersänger
Foenum graecum	Bockshornklee
For	Bewohner
Formalismus	Bevorzugung
Formerei	Herstellung
Formica	Ameise
Fort Jameson	Verwaltungssitz
Fort Riley	Militärposten
Forum	Rechtspflege
Léon Foucault	Physiker
Oscar Bardy de Fourtou	Oscar
Fox	Stifter
Foxkanal	Meeresarm
Frame	Waffe
Fränkische Schweiz	Gebirgslandschaft
Frauenberg	Schloß
Fraxinus	Esche
Fredensborg	Schloß
Fregattenkapitän	Seeoffizier
Freibank	Verkaufsstelle
Freibodenmänner	Partei
Freies Deutsches Hochstift	Privatgesellschaft
Freitag	Wochentag
Frigg	Göttin
Froben	Stallmeister
Fröhliche Wiederkunft	Jagdschlößchen
Frumentius	Apostel
Fucus	Blasentang
Fuego	Vulkan
Fu-hi	Gründer
Fund	Stiftung
Funddiebstahl	Verheimlichung
Funki	Neger
Funktionswechsel	Umwandlung
Furlaner	Bewohner
Fürstengroschen	Thüringer
Fürstenmantel	Mantel
Fürstenstein	Schloß
Fusijama	Vulkan
Futoi	Statthalter
Futterdiebstahl	Diebstahl
Fyne	Meerbusen
Gail Hamilton	Pseudonym
Galantuómo	Beiname
Galen	Pseudonym
Galileo Galilei	Physiker
Gallego	Nebenfluß
Gallegos	Bewohner
Gallertflechten	Abteilung
Gallion	Ausbau
Galopp	Gangart
Galvanochromie	Herstellung
Galvanoplástik	Benutzung
Gambette	Rotschenkel
Ganganelli	Familienname
Gänseadler	Seeadler
Gänsegeier	Geier
Gansfort	Vorläufer
Garbenkrähe	Mandelkrähe
Gardíst	Soldat
Gartenbau	Gärtnerei
Gartenbilch	Gartenschläfer
Gast	Matrose
Gauch	Kuckuck
Gauermann	Zeichner
Gault	Unterabteilung
Gaumen	Scheidewand
Gauting	Eremit
Gebirgsgeschütz	Geschütz
Gebühren	Vergütung
Ged	Goldschmied
Gediegen	Silber
Gehirnblasenwurm	Drehwurm
Gehirnlähmung	Aufhebung
Geierseeadler	Raubvogel
Johs. von Geissel	Erzbischof
Geistiges Eigentum	Urheberrecht
Gelbholz	Kernholz
Gelbveigelein	Goldlack
Geldbrief	Brief
Generalinquisitor	Vorsteher
Generalstab	Korps
Gennadios II.	Patriarch
Genoud	Erfinder
Gentilen	Angehörige
Ger	Wurfspieß
Gerade Aufsteigung	Rektaszension
Geschütz	Feuerwaffe
Geschwindschritt	Marschtempo
Gestellung	Vorführung
Gestütbuch	Verzeichnis
Gesundheitsgeschirr	Küchengeschirr
Getränkesteuer	Steuer
Geusen	Parteiname
Gewährleistung	Haftung
Gewerbeschein	Bescheinigung
Gewürzinseln	Molukken
Giebel	Begrenzung
Gigantostraken	Unterklasse
Gigerl	Wiener
Gila	Nebenfluß
Gipsverband	Verband
Giralda	Glockenturm
Girasol	Mondstein
Gitano	Zigeuner
James Glaisher	Physiker
Glasachat	Obsidian
Glasgalle	Verunreinigung
Glasgießerei	Herstellung
Glasschlange	Blindschleiche
Glauber	Chemiker
Glaukopis	Beiname
Gleicher	Verdeutschung
Glockenspiel	Musikinstrument
Glowacki	Pseudonym
Glücksburg	Seebad
Glühstrumpf	Glühkörper
Glutol	Einwirkung
Glykon	Bildhauer
Goar	Heiliger
Gog und Magog	Fürst
Gold	Metall
Goldafter	Schmetterling
Goldener Schnitt	Teilung
Goldforelle	Bachforelle
Goldhenne	Goldlaufkäfer
Goldkiebitz	Goldregenpfeifer
Goldköpfchen	Wintergoldhähnchen
Goldschlägerei	Fabrikation
Goldtaucher	Pinguin
Golgatha	Hügel
Golkonda	Festung
Golkvogel	Mandelkrähe
Gonochorismus	Verteilung
Gorjiu	Kleine
Gorkha	Volksstamm
Gorodowój	Schutzmann
Gottesfriede	Verbot
Gotteskasten	Barvermögen
Gotteskühchen	Marienkäfer
Gottorp	Schloß
Gourock	Seebad
Gouverneur	Befehlshaber
Gradierwage	Aräometer
Gradiska	Festung
Granatkorb	Reuse
Grand	Pseudonym
Granitpapier	Papier
Ulysses Simpson Grant	Ulysses
Graphideen	Abteilung
Grasmilbe	Larve
Grauhof	Klostergut
Graukopf	Grauspecht
Graumeise	Sumpfmeise
Henri Grégoire	Bischof
Greif	Pseudonym
Grenzfälschung	Unkenntlichmachung
Grien	Beiname
Grillvogel	Goldregenpfeifer
Großer Kurfürst	Kurfürst
Grottentaube	Felsentaube
Grün	Beiname
Grundföhre	Seeforelle
Grundlsee	Alpensee
Gründonnerstag	Donnerstag
Grundrechte	Rechte
Grundschuld	Pfandrecht
Grünmais	Futtermais
Grünsand	Glaukonit
Gryphus	Greif
Gualillos	Vulkan
Guanchen	Urbewohner
Gugelhopf	Süddeutschland
Guildhall	Rathaus
Guise	Festung
Gurd	Silbermünze
Gutenberg	Erfinder
Guzmán Blanco	Präsident
Gyritz	Lachmöwe
Gyrometer	Apparat
Haarbusch	Tschako
Haar der Berenice	Sternbild
Hacht	Habicht
Hadlaub	Minnesänger
Hadschi	Ehrenname
Haftpflichtversicherung	Versicherung
Hagelgans	Saatgans
Hagelversicherung	Versicherung
Hagioskop	Apparat
Hahnrei	Spottname
Haidá	Indianerstamm
Hainbund	Göttinger
Halbmond	Wahrzeichen
Hallberg-Broich	Reichsfreiherr
Halometer	Aräometer
Hämatose	Umwandlung
Hamilton	Pseudonym
Hamilton	Erfinder
Hämorrhoiden	Erweiterung
Hamstermaus	Schermaus
Handarbeitsunterricht	Anleitung
Handel	Industrie
Handelsgesetzbuch	Kodifikation
Handwechsel	Umtausch
Handwerk	Betrieb
Hängekompaß	Kompaß
Hängen	Erstickungstod
Harburger	Zeichner
Harpagus	Minister
Harpalus	Schatzmeister
Harper's Ferry	Städtchen
Hartington	Marquis
Harvard-Universität	Universität
Harzer Sauerbrunnen	Mineralquelle
Hasdrubal	Schwiegersohn
Haselrüsselkäfer	Haselnußbohrer
Hauffe	Seherin
Haurakigolf	Meerbusen
Hausdiebstahl	Diebstahl
Hausfideïkommiß	Stammgut
Hausierhandel	Handel
Hausierhandel	Gewerbebetrieb
Hauskauz	Steinkauz
Hausse	Steigen
Haussuchung	Durchsuchung
Havelock	Herrenmantel
Hebe	Göttin
Heber	Apparat
Hebräische Literatur	Nationalliteratur
Hebriden	Western
Heckenschmätzer	Dorngrasmücke
Hederich	Ackerrettich
Heer der Seligmacher	Heilsarmee
Heervogel	Wiedehopf
Hegau	Rhein
Hegesíppus	Kirchenschriftsteller
Hehlerei	Begünstigung
Heiligenberg	Schloß
Heiligendamm	Seebad
Heiliger-Geist-Orden	Orden
Heiter	Pseudonym
Hekate	Göttin
Helche	Gemahlin
Heldburg	Freifrau
Helioplástik	Herstellung
Heliotherapie	Behandlung
Hellbrunn	Schloß
Hellweg	Nordabhang
Hengist	Anführer
Hephästion	Liebling
Herausforderung	Aufforderung
Herbstlachs	Seeforelle
Herne Bay	Seebad
Hero	Priesterin
Hero	Mathematiker
Heroon	Heiligtum
Luce Herpin	Pseudonym
Herrenhausen	Lustschloß
Herzeloyde	Mutter
Hesperien	Römer
Heterokliton	Substantiv
Heubude	Seebad
Hexaeder	Kristallform
Hexapla	Bibelwerk
Hexentanzplatz	Felswand
Hiawatha	Lehrer
Hienzen	Deutsche
Hiëro	Herrscher
Hiëromonachos	Mönch
Hiëronymus	Heilige
Hiëronymus	Gesinnungsgenosse
Hiëroskopie	Weissagung
High Tory	Aristokrat
Hilfen	Einwirkung
Hilfskreuzer	Schnelldampfer
Hilus	Einbuchtung
Himalajabär	Kragenbär
Himmelsgucker	Stachelflosser
Hinc illae lacrimae	Zitat
Hinkmar	Erzbischof
Hinterwäldler	Ansiedler
Hippárch	Befehlshaber
Hippárchus	Gründer
Hippias	Tyrann
Hiragana	Silbenschrift
Hirnblasenwurm	Drehwurm
Hirnquese	Drehwurm
Hirschhorn	Geweih
Hirtius	Legat
Hirudo	Blutegel
Hirundo	Schwalbe
Hissarlik	Anhöhe
Histiäus	Tyrann
Histrionen	Schauspieler
Hoáchanas	Militärposten
Hochmeister	Oberhaupt
Hoch- und Deutschmeister	Ordensmeister
Hodegetik	Anweisung
Hoffmann & Campe	Buchhandlung
Hofwyl	Landgut
Hohenau	Gräfin
Höhenmessung	Feststellung
Hohenrechberg	Schloßruine
Hoher Stauffen	Bergrücken
Hohkönigsburg	Ruine
Hohlzirkel	Zirkel
Hohneklippen	Felsengruppe
Holländer	Maschine
Höllenstein	Argentum
Holzkonservierung	Bewahrung
Holzmeise	Tannenmeise
Holzschnepfe	Waldschnepfe
Holzweberei	Verfertigung
Holzwürmer	Splint
Homagial	Huldigung
Homiletik	Anleitung
Honigbussard	Wespenbussard
Honorar	Vergütung
Honorieren	Honorar
Hont	Flußarm
Honter	Reformator
Hontheim	Weihbischof
Hopedale	Missionsstation
Horizontalpendel	Apparat
Horn	Pseudonym
Hornpipe	Musikinstrument
Hornschlange	Hornviper
Hornung	Februar
Horror	Scheu
Horuk	Herrscher
House of Commons	Unter
Houses of Convocation	Parlament
Hucbald	Musiker
Humaïtá	Festung
Humerale	Schultertuch
Humus	Pflanzen
Hungerkur	Entziehung
Huongolf	Meerbusen
Hyalotypie	Herstellung
Hydrioten	Bewohner
Hylas	Liebling
Hyméttus	Berggruppe
Hyperbasis	Versetzung
Hyperdakytlie	Auftreten
Hyphén	Zusammenziehung
Iakchos	Beiname
Iambus	Versfuß
Ibar	Nebenfluß
Idhun	Hüterin
Idrosee	Alpensee
Igls	Sommerfrische
Ignis et aquae interdictio	Untersagung
Ik Marvel	Pseudonym
Ikositetraeder	Kristallform
Iktinus	Erbauer
Imâmiten	Partei
Imbergans	Eistaucher
Impaß	Gasse
Impeachment	Anklage
Indent	Vertrag
Indianíst	Kenner
Indigen	Handelsname
Industrie	Industrie
Industriéll	Industrie
Inhibieren	Einhalt
Initiative	Einleitung
Injektion	Einspritzung
Inlett	Leinen
Innanke	Seeforelle
Innewache	Wache
Inquilin	Einwohner
Inster	Gekröse
Institut de France	Institut
Intarsienmalerei	Intarsia
Inter arma silent leges	Unter
Intermission	Aussetzen
Interpretation	Erklärung
Inthronisation	Erhebung
Inventarium	Verzeichnis
Involutionsperiode	Alter
Irazú	Vulkan
Iron	Pseudonym
Ironside	Beiname
Isafjord	Handelsplatz
Isenschnippe	Schloß
Istambol Efendisi	Efendi
Ith	Gebirgsrücken
Ituri	Nebenfluß
Iwángorod	Festung
Iztaccihuatl	Vulkan
Jacqueiraholz	Stammholz
Jakub Beg	Beherrscher
Jalu-kiang	Grenzfluß
Jamunder See	Strandsee
Jänner	Januar
Jaschmak	Schleier
Jauner	Ritter
Jaxt	Nebenfluß
Jeanne d'Arc	Jungfrau
Jeffreys	Lordkanzler
Jehu	Feldherr
Jenatsch	Schweizer
Jenner	Januar
Edward Jenner	Entdecker
Jerobeam	Beamter
Joab	Stiefschwester
Joch	Geschirr
Jodocus	Markgraf
Jopenbier	Danziger
J. U. D.	Doktor
Judex	Richter
Jugerum	Rechteck
Julirevolution	Revolution
Jungermannia	Lebermoos
Jungfrauen	Heilige
Jüngstenrecht	Bevorzugung
Jura	Rechte
Justitia	Göttin
Justitium	Stillstand
Jüten	Bewohner
Kabarda	Gebirgslandschaft
Kabbala	Geheimlehre
Kadétt	Zögling
Kadinen	Rittergut
Kadmos	Gründer
Kahnbein	Handwurzelknochen
Kahnschnabel	Vogel
Kaïn	Mörder
Kalade	Anhöhe
Kalásche	Tracht
Kalbeck	Publizist
Kälbermagen	Magen
Kalchas	Priester
Kalender	Einteilung
Kalender	Blättermagen
Kalewala	Nationalepos
Kalibermaßstab	Zirkel
Kallíppus	Urheber
Kallipygos	Beiname
Kallisthenes	Begleiter
Kalorimeter	Apparat
Kama	Nebenfluß
Kamaun	Division
Kamelopard	Giraffe
Kämmaschine	Maschine
Kammergericht	Appellationsgericht
Kammerjäger	Jäger
Kammlerche	Haubenlerche
Kamorondo	Nebenfluß
Kampf ums Dasein	Zitat
Kamtschatkisches Meer	Beringmeer
Kanaken	Bewohner
Kanara	Küstenlandschaft
Kanawha	Nebenfluß
Kandare	Zaumzeug
Kandioten	Bewohner
Kaníster	Blechkiste
Kanoníst	Kenner
Kanuri	Einwohner
Kapitän	Führer
Kaption	Fangen
Kapurthala	Vasallenstaat
Karbolwatte	Rizinusöl
Kardiograph	Apparat
Karer	Bewohner
Karrier	Kasse
Kartoffelwage	Apparat
Käsemagen	Labmagen
Kasperl	Person
Kastenfassung	Befestigung
Kat	Strauch
Katalog	Verzeichnis
Katholikos	Ehrentitel
Kaufmannsgericht	Sondergericht
Kehlkopf	Pförtner
Keiler	Schwarzwild
Kemény	Fürst
Keratoskop	Apparat
Kerze	Beleuchtungskörper
Khan	Fürstentitel
Khlesl	Kardinal
Kiachta	Handelsplatz
Kiefernraupe	Raupe
Kiel	Balken
Kieler Umschlag	Messe
Kieselschiefer	Kohlenstoff
Kilimatinde	Militärstation
Kiln	Schachtofen
Kinderehe	Vermählung
Kirchendiebstahl	Diebstahl
Kirchenjahr	Jahreszyklus
Kisaki	Militärstation
Kissaki	Militärstation
Kita	Militärstation
Kithara	Gitarre
Kitze	Junge
Klage	Geltendmachung
Klampenborg	Seebad
Klassizismus	Empirestil
Klein	Literarhistoriker
Kleingewerbe	Gewerbe
Klein-Popo	Handelsplatz
Kleinspecht	Buntspecht
Kleisthenes	Tyrann
Kleobulus	Tyrann
Klieben	Flußneunauge
Klimatographie	Beschreibung
Klinik	Unterricht
Klischee	Abguß
Kniebis	Bergsattel
Kniegeige	Gambe
Knights of Labor	Ritter
Knipperdollinck	Führer
Knivsberg	Erhebung
Knochenfische	Unterklasse
Knox	Reformator
Koberger	Buchdrucker
Kobsa	Spieler
Kohärer	Apparat
Kohinur	Diamant
Kohlamsel	Schwarzdrossel
Koinobion	Kloster
Koïpu	Sumpfbiber
Kokytos	Nebenfluß
Kolarier	Urbewohner
Kölberlstahl	Rohstahl
Kollegiatkirche	Pfarrkirche
Kollergang	Zerkleinerungsmaschine
Kolliquation	Entkräftung
Kolonialabteilung	Abteilung
Kolonisation	Begründung
Kombination	Zusammenfassung
Kommandánt	Befehlshaber
Kommandite	Zweigniederlassung
Kommittént	Auftraggeber
Kommodore	Kapitän
Kompletorium	Gebetsstunde
Kompréssor	Maschine
Konfiskation	Wegnahme
Kongréß	Zusammenkunft
Könige	Heilige
Königsau	Grenzfluß
Königsfischer	Eisvogel
Königsgelb	Kölner
Königsgrenadiere	Grenadierregiment
Königspinguin	Riesenpinguin
Königstaucher	Riesenpinguin
Konjugaten	Abteilung
Konrektor	Amtstitel
Konstituierende Versammlung	Versammlung
Kontinental	Festland
Konventikel	Versammlung
Kopfstück	Münze
Korjaken	Volksstamm
Korybánten	Begleiter
Kosák Lugánskij	Pseudonym
Kosmographie	Beschreibung
Kote	Bauernhaus
Kötenzopf	Haarbüschel
Koterie	Partei
Kotgeier	Aasgeier
Kotschwalbe	Uferschwalbe
Kotvogel	Wiedehopf
Kragennatter	Ringelnatter
Krähenspecht	Schwarzspecht
Kral	Hüttendorf
Kran	Apparat
Krankenversicherung	Versicherung
Kraterus	Heerführer
Kratzbeere	Brombeere
Kräuterkissen	Säckchen
Kreditversicherung	Versicherung
Kreodonten	Vorläufer
Krepitation	Geräusch
Kresilas	Zeitgenosse
Kreuzer	Scheidemünze
Kreuzfahrer	Teilnehmer
Kreuzritter	Teilnehmer
Kri	Indianerstamm
Kriegsministerium	Verwaltungsbehörde
Kriegsrat	Versammlung
Kriegsversicherung	Versicherung
Kriens	Pfarrdorf
Kriminal	Strafrecht
Kriminalíst	Lehrer
Kriminalität	Verhalten
Krimkrieg	Krieg
Krippe	Sternhaufen
Kritias	Redner
Krone von Indien	Orden
Kronstadt	Seefestung
Kronwerk	Außenwerk
Kropfente	Krähenscharbe
Kröteneier	Volksname
Kryptophon	Apparat
Ktesias	Zeitgenosse
Kublai	Enkel
Küchenelster	Mandelkrähe
Kuckucksknecht	Wiedehopf
Kuder	Wildkatze
Kujundschik	Ruinenhügel
Kuma	Kragenbär
Kumaon	Division
Kunkel	Alchimist
Kunstrad	Wasserrad
Kunstschmiedearbeiten	Schmiede
Kupferdruckerschwarz	Frankfurter
Kupferfasan	Fasan
Kupolofen	Schachtofen
Küraß	Brustharnisch
Kureten	Priester
Kurfürstenhut	Kopfbedeckung
Kurialíst	Beamter
Kurisches Haff	Strandsee
Kurpfuscherei	Ausübung
Kurprinz	Erbprinz
Kursieren	Umlauf
Kuruman	Missionsstation
Kurzwildbret	Hoden
Kuschiten	Bewohner
Kydonia	Tempel
Kyparissos	Liebling
Kyzlar Agassy	Oberaufseher
Laach	Benediktinerabtei
Ladon	Nebenfluß
Laferté	Pseudonym
Lagenaria vulgaris	Flaschenkürbis
Lagenevais	Pseudonym
Lagiden	Beiname
Lahire	Heerführer
Laienspiegel	Rechtsbuch
Laja	Nebenfluß
Laktation	Absonderung
Lambic	Buchweizen
Laminieren	Metall
Lamischer Krieg	Krieg
Landesausschuß	Volksvertretung
Landesschützen	Landwehr
Landesversicherungsamt	Zentralbehörde
Landgerichtsdirektor	Amtstitel
Landgerichtspräsident	Amtstitel
Landmeister	Würdenträger
Landrichter	Amtstitel
Landsgemeinden	Bürgerversammlung
Landsthing	Erste
Landsturm	Aufgebot
Landwehrkreuz	Abzeichen
Landwirtschaft	Industrie
Lange	Romanschriftsteller
Langesund	Städtchen
Lanista	Fechtmeister
Lanninon	Seebad
Lanquart	Nebenfluß
Lanz	Pseudonym
Lanze	Stoßwaffe
Lapidarschrift	Nachahmung
L'appétit vient en mangeant	Appetit
Larix	Lärche
La Roche	Ritter
Lasca	Beiname
Lasen	Bewohner
Laski	Bischof
Kurd Laßwitz	Philosoph
Latifundium	Landgut
Latimer	Märtyrer
Latitudinarier	Partei
La Trappe	Kloster
Latsche	Quellsee
Latter-Day Saints	Mormonen
Laurus	Lorbeer
Lausitzer Gebirge	Lausitzer
Lavabo	Waschbecken
Lederfabrikation	Verwandlung
Legionär	Soldat
Legitimation	Nachweis
Lehmguß	Gießen
Leibung	Durchbrechung
Leicheneule	Steinkauz
Leichenhuhn	Steinkauz
Leichenraub	Wegnahme
Leichenvogel	Steinkauz
Leina	Kleine
Leinenfischerei	Angelfischerei
Lenôtre	Schöpfer
Lentulus	Beiname
Lermolieff	Pseudonym
Le Roy	Seigneur
Lesse	Nebenfluß
Leuconostoc mesenterioides	Erreger
Leukorrhöe	Weißer
Leukosyrer	Bewohner
Leuzitit	Leuzit
Leye	Nebenfluß
Libussa	Begründerin
Licancaur	Vulkan
Lichtgeschwindigkeit	Geschwindigkeit
Liegnitz	Fürstin
Liek	Tauwerk
Lietze	Wasserhuhn
Likedeler	Beiname
Lindi	Militärstation
Linkshändigkeit	Verrichtung
Literarkonvention	Vertrag
Litewka	Uniformrock
Litholyse	Auflösung
Litwos	Pseudonym
Livreeraupe	Raupe
Liwale	Militärstation
LL.D.	Doktor
Llullaillaco	Vulkan
Loa	Vorspiel
Loangoküste	Küstenlandschaft
Lochmaschine	Maschine
Lochsäge	Handsäge
Lohfink	Gimpel
Lohme	Seebad
Loko	Handelsplatz
Lolli	Verfasser
Lolo	Eingeborene
Lombardus	Schüler
Longchamps	Rennplatz
Longimanus	Beiname
Longimetrie	Geometrie
Longwood	Meierei
Longwy	Grenzfestung
Lonza	Nebenfluß
Loo	Schloß
Lorgnette	Brille
Lorm	Pseudonym
Los	Stäbchen
Löschhorn	Pianist
Loti	Pseudonym
Low Church	Partei
Lowell-Mitrailleuse	Schnellfeuergeschütz
Löwentaler	Silbermünze
Lowry	Eisenbahnwagen
Lualaba	Quellfluß
Luchs	Sternbild
Lucina	Beiname
Lufft	Buchdrucker
Luggerbank	Sandbank
Lullus	Scholastiker
Lumpfisch	Seehase
Lunarium	Apparat
Lunden	Kirchspiel
Lungenentzündung	Durchsetzung
Lupus	Zitat
Luxembourg	Palast
Luzk	Festung
Lyall	Pseudonym
Lykopodinen	Abteilung
Lykúrgus	Gesetzgeber
Lynkeus	Verlobter
Lysimachus	Feldherr
Lyskowó	Kirchdorf
Macaluba	Schlammvulkan
Macao	Hasardspiel
MacCluer-Golf	Meerbusen
Madagassen	Einwohner
Maëstà	Christus
Mafia	Geheimbund
Magádis	Harfe
Magelone	Heldin
Mahadeva	Beiname
Maiföhre	Seeforelle
Mainfeldzug	Krieg
Maipo	Vulkan
Maipure	Indianerstamm
Maire	Vorsteher
Maisrebbler	Maschine
Majuba	Tafelberg
Makrosomie	Riesenwuchs
Malagasch	Einwohner
Malakostraken	Unterklasse
Malakow	Bastion
Malansche	Militärstation
Malegassen	Einwohner
Malgaschen	Einwohner
Mali-kha	Quellfluß
Malleolus	Knöchel
Maltatal	Hochgebirgstal
Maltoleguminose	Leguminose
Mamertus	Erzbischof
Mamma	Brust
Manche	Meeresarm
Mancini	Nichte
Mandi	Vasallenstaat
Manes	Stifter
Mange	Wurfmaschine
Mani	Stifter
Manikure	Pflege
Manilius	Verfasser
Manipel	Unterabteilung
Manipur	Vasallenstaat
Manks	Bewohner
Manno	Pseudonym
Mansion House	Amtswohnung
Mantelrohr	Geschützrohr
Manubien	Kriegsbeute
Mäonide	Beiname
Mapes	Günstling
Maphrian	Bischof
Mar del Plata	Seebad
Margolf	Eichelhäher
Marilaun	Ritter
Mariottesche Ausflußflasche	Apparat
Markwaldungen	Eigentum
Marlitt	Pseudonym
Maro	Familienname
Marquard	Eichelhäher
Marquise	Gemahlin
Marriot	Pseudonym
Marvel	Pseudonym
Märzblümchen	Leberblümchen
Maschinenpersonal	Personal
Masínde	Militärstation
Massaï	Volksstamm
Massegläubiger	Gläubiger
Masseter	Kaumuskel
Mastdarmfistel	Fistel
Mátra	Berggruppe
Matrikel	Verzeichnis
Mattervisp	Abfluß
Matthäus	Apostel
Matthäus	Stifter
Maturadiamant	Handelsname
Mauerspecht	Mauerläufer
Maultier	Bastard
Mauschel	Spottname
Mäusegeier	Mäusebussard
Mauser	Ablösung
Maya	Indianerstamm
Mayor	Dublin
Mbambwa	Militärstation
Mbuju	Affenbrotbaum
Mechanotherapie	Behandlung
Mechitaristen	Kongregation
Medem	Nebenfluß
Medem	Reichsgräfin
Medizinalpflanzen	Pflanzen
Meeradler	Seeadler
Mehemed Ali	Vizekönig
Mehlfabrikation	Herstellung
Mehlvogel	Kornweihe
Meißelpflug	Pflug
Me-kha	Quellfluß
Melanoskop	Zusammenstellung
Melanter	Pseudonym
Melitämie	Zuckergehalt
Melodrama	Schauspiel
Melusine	Stammmutter
Men	Mondgott
Menelik	Kaiser
Menenius Agrippa	Gesandte
Mensaleh	Strandsee
Mera	Zufluß
Mercerisation	Behandlung
Meredith	Pseudonym
Mérite	Orden
Mesenterium	Gekröse
Mesolithisch	Steinzeit
Mesomphalium	Nabel
Meßbrief	Urkunde
Messinggießerei	Herstellung
Meßkonten	Kontierung
Metemptose	Ausfall
Methylgrün	Pariser
Metronom	Apparat
Metrotomie	Kaiserschnitt
Michatoyat	Abfluß
Mikrographie	Beschreibung
Mikrometerzirkel	Apparat
Mikrosomie	Kleinheit
Milchwage	Aräometer
Militärstrafgesetzbuch	Gesetzbuch
Militärveterinärwesen	Personal
Millstone-grit	Sandstein
Mimnérmus	Schöpfer
Mimograph	Verfasser
Mimosazeen	Abteilung
Mindere Brüder	Franziskaner
Minderungsklage	Klage
Miquelets	Bergbewohner
Mirza Schaffy	Lehrer
Mises	Pseudonym
Missale	Meßbuch
Misti	Vulkan
Mitisguß	Eisenguß
Mitreederei	Verein
Mittelhuhn	Bastard
Mittelwort	Verdeutschung
Mittfasten	Mittwoch
Mittwoch	Wochentag
Mixteka	Indianervolk
Mnesikles	Erbauer
Mogador	Handelsplatz
Mogdischu	Handelsplatz
Mohammed	Stifter
Mohammedanismus	Islam
Mohoro	Handelsplatz
Mohrrübe	Gemüsepflanze
Mokkastein	Chalzedon
Molina	Lehrer
Molkereiwesen	Verarbeitung
Molossus	Versfuß
Mômiers	Spottname
Monarchie	Staatsform
Mönchsadler	Geier
Mönchsschrift	Handschrift
Mondsee	Alpensee
Moneta	Beiname
Monocycle	Fahrrad
Monókel	Augenglas
Monokulares Sehen	Sehen
Monsune	Winde
Mont-Avron	Anhöhe
Montenuovo	Fürst
Monte Vergine	Kloster
Montferrat	Markgraf
Montfort	Fürst
Mont-Genèvre	Bergpaß
Mont-Pelé	Vulkan
Montreux	Kirchspiel
Mont-Valérien	Hügel
Moorbirkhuhn	Bastard
Mordwinen	Völkerschaft
Morecambebai	Meerbusen
Moscherosch	Schriftsteller
Moselotte	Kleine
Moskowiter	Einwohner
Mostwage	Aräometer
Moulinet	Drehkreuz
Mount Vernon	Landgut
Mowana	Affenbrotbaum
Mubarraz	Festung
Mull	Maulwurf
Müller	Mehlkäfer
Müller	Freund
Multatuli	Pseudonym
Mundraub	Entwendung
Münzfälschung	Herstellung
Murad Efendi	Schriftsteller
Mürren	Bergdorf
Mirza Musaffer ed-dîn	Schah
Musagétes	Beiname
Musca	Fliege
Muschik	Bauer
Musivisches Sehen	Sehen
Mustapha	Großwesir
Musterrolle	Urkunde
Mutinensischer Krieg	Belagerung
Mutoskop	Apparat
Mutter Gottes	Jungfrau
Mutterrolle	Verzeichnis
Muzaffer ed-dîn	Schah
Myiodesopsie	Flimmern
Mykenä	Herrschersitz
Mylius	Pseudonym
Myrmidonen	Kriegsvolk
Mythographen	Schriftsteller
Nab	Nebenfluß
Nabis	Tyrann
Nabob	Verwalter
Nachindossament	Indossament
Nachtkauz	Waldkauz
Nachtwandeln	Somnambulismus
Nadeldiorit	Diorit
Nadelstuhl	Webstuhl
Nadir	Schah
Nagájka	Peitsche
Namâz	Gebet
Narówa	Abfluß
Nase	Geruchsorgan
Naso	Beiname
Natalitium martyris	Todestag
Nativität	Prophezeiung
Natrium	Alkalimetall
Natunainseln	Archipel
Nauplia	Napoli
Nautik	Zusammenfassung
Navigare necesse est, vivere non est necesse	Schiffahrt
Nazarener	Beiname
Neander	Freund
Neander	Humanist
Neapel	Prinz
Neárchus	Jugendfreund
Nebraska	Nebenfluß
Necessaire	Kästchen
Neers	Nebenfluß
Negatorienklage	Klage
Negritos	Ureinwohner
Neige	Wollstoff
Neith	Gefährtin
Nekromantie	Weissagung
Nellerto	Pseudonym
Nena-Sahib	Führer
Filippo Neri	Stifter
Nervenkrankheiten	Nervensystem
Nest	Seebad
Netzfischerei	Fischfang
Netzhautablösung	Abhebung
Neubabelsberg	Villenkolonie
Neuer Stil	Zeitrechnung
Neuherrnhut	Missionsstation
Neujahrsfest	Feier
Neuschwanstein	Schloß
Neustädter Bucht	Lübecker
Neutralität	Nichtteilnahme
Newar	Urbevölkerung
Newjánskij-Sawód	Hüttenwerk
Nichtigkeitsbeschwerde	Rechtsmittel
Nideck	Schloßruine
Niederyssel	Kleine
Niggeröl	Baumwollsamenöl
Nimbschen	Klosterruine
Nioro	Handelsplatz
Nivellement	Messen
Njegusch	Beiname
Njördhr	Schiffahrt
Nomárch	Vorsteher
Nonintrusionisten	Partei
Nonnenentchen	Säger
Nordgermanen	Bewohner
Nordostpassat	Passat
North	Pseudonym
Nortonsund	Busen
Norwegische Nachtigall	Rotdrossel
Notensteuer	Steuer
Notieren	Feststellung
Nötigung	Vergehen
Notwehr	Verteidigung
Novalis	Pseudonym
Novation	Tilgung
Nowogeorgijéwsk	Festung
Nufenenpaß	Bergpaß
Nußbeißer	Kernbeißer
Nut	Mutter
Obduktion	Besichtigung
Obergefreiter	Dienstgrad
Oberjäger	Unteroffizier
Oberrichter	Amtstitel
Oberstleutnant	Dienstgrad
Obervormundschaft	Oberaufsicht
Oboe	Holzblasinstrument
Obstwickler	Apfelwickler
Ochsenfisch	Lamantin
Ofenpaß	Alpenpaß
Ofotenfjord	Fjord
O'Hara	Pseudonym
Ohrkauz	Zwergohreule
Okahandja	Militärstation
Oktoberdiplom	Manifest
Ölfarbendruck	Nachahmung
Ölschiefer	Fischen
Olympieion	Tempel
Ombrés	Zeuge
Omega	Buchstabe
Onager	Wurfmaschine
Onomakritus	Wahrsager
Önotrer	Bewohner
Opener	Reinigungsmaschine
Opfer	Darbringung
Ophikleide	Blasinstrument
Opisthobranchiaten	Hinterkiemer
Opiumkrieg	Krieg
Optimus	Beste
Optisch	Sehen
Oranienstein	Schloß
Oranjeflußkolonie	Orange
Oratorianer	Priester
Oratorium	Kapelle
Orbilius Pupillus	Lehrer
Orbilius Pupillus	Grammatiker
Ordenskapitel	Versammlung
Ordinieren	Ordination
Organotherapie	Behandlung
Orianda	Besitzung
Orientalíst	Kenner
Grigorij Orlow	Günstling
Ornat	Amtskleidung
Ornithologie	Naturgeschichte
Ornus	Blumenesche
Orphaniten	Partei
Orsatscher Apparat	Apparat
Orth	Schloß
Ortsdienst	Offizier
Osagen	Indianerstamm
O'Shannassyfluß	Quellfluß
Osman	Gründer
Osman Digna	Parteigänger
Ossip Schubin	Pseudonym
Ostermesse	Frühjahrsmesse
Ostermonat	April
Osterstein	Residenzschloß
Othmân	Kalif
Othomi	Volksstamm
Otjomokojo	Militärstation
Ouida	Pseudonym
Ouvirándra fenestralis	Wasserpflanze
Ouvrier	Arbeiter
Ovine	Impfung
Oxford	Abteilung
Oyapoc	Grenzfluß
Bartolommeo Pacca	Kardinal
Pädiater	Behandlung
Padischah	Kaiser
Paian	Beiname
Palais-Royal	Palast
Paläologen	Herrscher
Palatina	Heidelberger
Palimpsést	Handschrift
Palingenesie	Wiederentstehung
Palínurus	Steuermann
Palmenfest	Laubhüttenfest
Palmkohl	Euterpe
Palpikornier	Wasserkäfer
Pamlicosund	Meeresarm
Pamphlet	Verfasser
Panamerikanischer Kongreß	Versammlung
Panhellenion	Heiligtum
Pankreas	Bauchspeicheldrüse
Pantalone	Charaktermaske
Pantänus	Vorsteher
Pantschmaschine	Waschmaschine
Panzerbarsch	Stachelflosser
Panzerkreuzer	Kreuzer
Papier	Papyrusstaude
Papilionazeen	Abteilung
Papyrograph	Apparat
Parachute	Fallschirm
Paragium	Abfindung
Paraguay	Republik
Paralexie	Schriftzeichen
Paraphérnen	Sondervermögen
Pare	Gebirgslandschaft
Parens	Bewohner
Parfümerie	Bereitung
Parlamentarisch	Parlament
Parlatorium	Sprechzimmer
Parmenion	Vertrauter
Par nobile fratrum	Zitat
Paronomasie	Zusammenstellung
Parotis	Ohrspeicheldrüse
Paß	Gangart
Passigdrehen	Herstellung
Pastor	Pfarrer
Pastorale	Singspiel
Pastoralsinfonie	Sinfonie
Pastorat	Amtswohnung
Pastorellen	Teilnehmer
Patan	Ortsname
Patarener	Spottname
Pater seraphicus	Beiname
Pathophobie	Furcht
Patibulum	Querbalken
Patn	Ortsname
Patois	Dialekt
Patronendrehbank	Drehbank
Pattan	Ortsname
Pauken	Duellant
Pawnee	Indianerstamm
Paznauntal	Hochgebirgstal
Peale	Pseudonym
Pecci	Familienname
Pechuenche	Dialekt
Pedro	Kaiser
Pegu	Division
Peigneur	Abnehmer
Peinture-mate	Malerei
Peisistratos	Tyrann
Peleus	Beherrscher
Pelide	Beiname
Pellegrin	Pseudonym
Pelseide	Seide
Pensionär	Zögling
Pentere	Kriegsschiff
Peperino	Albaner
Peplos	Festgewand
Perdikkas	Vertrauter
Perey	Pseudonym
Perhorreszieren	Schauder
Perióst	Knochenhaut
Peripatetische Philosophie	Philosophie
Peritonäum	Bauchfell
Perkun	Donnergott
Permier	Volksstamm
Persönliche Klage	Klage
Peschiera	Festung
Alexandre Pétion	Präsident
Petitor	Bewerber
Petschérskaja Lawra	Kloster
Pfahlwurm	Schiffsbohrwurm
Pfalzgrafenstein	Schloß
Pfändung	Ergreifung
Pfänner	Besitzer
Pfarrer	Geistliche
Pferdegelder	Entschädigung
Pflaume	Obstgehölz
Pflaumenmotte	Motte
Pflug	Ackergerät
Phädon	Schüler
Phenanthren	Begleiter
Phiale	Trinkschale
Philadélphus	Beiname
Philalethes	Schriftstellername
Philetärus	Stifter
Phlegmatiker	Mensch
Phokis	Berglandschaft
Phorminx	Kithara
Photochromatische Theraphie	Behandlung
Photochronograph	Kamera
Phryne	Hetäre
Phul	Beiname
Phyllotáxis	Blattstellung
Physikus	Kenner
Physostigma venenosum	Kletterpflanze
Phyto	Pflanzen
Phytotherapie	Behandlung
Picander	Pseudonym
Pichincha	Vulkan
Piëriden	Beiname
Pike	Lanze
Pincenez	Brille
Pinealdrüse	Zirbeldrüse
Pipette	Glasröhre
Pisistratus	Tyrann
Pissa	Quellfluß
Pitztal	Hochgebirgstal
Pizarro	Entdecker
Plakoiden	Fische
Planetarium	Maschine
Plantagenet	Zuname
Plärre	Bläßhuhn
Platzangst	Angstzustand
Plenarsitzung	Versammlung
Plon-Plon	Spitzname
Pluvius	Beiname
Pneumatograph	Apparat
Poken	Vorarbeit
Polaristrobometer	Apparat
Polias	Beiname
Poliment	Goldgrund
Politesse	Artigkeit
Polka	Rundtanz
Polo	Ballspiel
Polychromographie	Herstellung
Polyklet	Meister
Polykrates	Tyrann
Polymetrie	Vielheit
Polyspérchon	Feldherr
Polyzoen	Moostierchen
Pomeen	Unterabteilung
Pomona	Gemahlin
Pompejus Trogus	Zeitgenosse
Ponta da Lenha	Handelsplatz
Pontifikalmesse	Messe
Pontus Euxinus	Schwarze
Popocatepetl	Vulkan
Populus	Pappel
Pornograph	Verfasser
Porphyr	Eruptivgestein
Porphyrogennetos	Beiname
Porrosche Operation	Entbindung
Porsanger Fjord	Meerbusen
Port Darwin	Einbuchtung
Portefeuille	Mappe
Port Essington	Einbuchtung
Portiunkula	Kirchlein
Portofreiheit	Vergünstigung
Portsdownhügel	Hügel
Port Sudan	Scheik
Posilípo	Hügel
Postalisch	Postverwaltung
Postauftrag	Einziehung
Postskriptum	Nachschrift
Postzwang	Gebot
Potaro	Nebenfluß
Poterie	Herstellung
Präbénde	Inhaber
Praguerie	Aufstand
Prälegat	Vermächtnis
Prämienversicherung	Versicherungsvertrag
Präparánd	Schüler
Präputium	Vorhaut
Präsidént	Vorsitzende
Praxis	Ausübung
Präzéptor	Lehrer
Premier	Erste
Presenning	Laken
Preßluftgründung	Herstellung
Preußische Jahrbücher	Berliner
Priester	Vermittler
Primär	Erste
Primiero	Bezirkshauptmannschaft
Princeps	Erste
Prinzenraub	Entführung
Priscillian	Stifter
Proceleusmaticus	Versfuß
Prodigium	Vorzeichen
Proféß	Ordensgelübde
Progymnasium	Vorschule
Prokonsuln	Stellvertreter
Prokrústes	Beiname
Pronuba	Beiname
Propheten	Verkündiger
Prophyláxe	Verhütung
Prorer Wiek	Meerbusen
Protokóll	Feststellung
Protze	Vorderwagen
Prozeßeinrede	Geltendmachung
Prusias	Gründer
Psittacus	Papagei
Psychagogos	Beiname
Psychophysik	Naturlehre
Puelches	Indianerstamm
Pulmo	Lunge
Pulper	Maschine
Punch	Hanswurst
Puri	Indianerstamm
Purulént	Eiter
Putation	Dafürhalten
Putumayo	Nebenfluß
Puy-de-Dôme	Berggruppe
Pyknometer	Glasfläschchen
Pyromanie	Weissagung
Pyrotéchnik	Wärmelehre
Quadratur	Verwandlung
Quäkerpoet	Beiname
Qualifikation	Beilegung
Quan	Münze
Quango	Nebenfluß
Quarkringel	Neuntöter
Quarnero	Meerbusen
Quasiususfruktus	Nießbrauch
Quatrain	Strophe
Quatre-Bras	Meierei
Quechua	Ketschua
Quecksilberpflaster	Quecksilber
Quellsonden	Stäbchen
Quercus	Eiche
Quiberon	Landzunge
Rabbi	Ehrentitel
Rad	Strafe
Räderalbus	Trier
Rákóczy	Mineralquelle
Rakun	Waschbär
Ramlösa	Mineralbad
Rammschiff	Panzerschiff
Rampur	Vasallenstaat
Ran	Morast
Rana	Frosch
Rapidan	Nebenfluß
Rapier	Degen
Rappoltstein	Burgruine
Ratramnus	Benediktinermönch
Räuchern	Methode
Rauchverhütung	Verhinderung
Ravaillac	Mörder
Razinsee	Strandsee
Realsche Presse	Apparat
Recht auf Arbeit	Forderung
Rechtshilfe	Vornahme
Rechtskonsulént	Ratgeber
Rectum	Mastdarm
Redcliffe	Viscount
Redemptoristen	Orden
Redende Künste	Dichtkunst
Redhibition	Rückgabe
Reeder	Eigentümer
Refaktie	Abzug
Refektorium	Speisesaal
Referieren	Bericht
Regenbogen	Lichtbogen
Regens	Aufseher
Regenschnepfe	Wasserläufer
Regenstein	Burgruine
Regenvogel	Regenbrachvogel
Regie	Staatsbetrieb
Mathurin Regnier	Schöpfer
Rehabilitation	Wiedereinsetzung
Reichsadler	Doppeladler
Reichsdruckerei	Reichsanstalt
Reichseisenbahnamt	Reichsbehörde
Reichspostamt	Behörde
Reichsrennfahne	Feldzeichen
Reinbot	Dienstmann
Reitwurm	Maulwurfsgrille
Reï vindicatio	Klage
Rektoskop	Apparat
Reliefkopiermaschine	Apparat
Religionsphilosophie	Erörterung
Rellmaus	Siebenschläfer
Reminiszere	Fastensonntag
Remisier	Vermittler
Remonstrieren	Gegenvorstellung
Remuneration	Belohnung
Renner	Lehrgedicht
Repertoire	Verzeichnis
Repetént	Gehilfe
Reposition	Wiedereinrichtung
Reserveoffiziere	Wehrpflichtige
Resonator	Apparat
Respirationsapparat	Apparat
Restitutio in integrum	Wiedereinsetzung
Reticulum	Netzmagen
Retraite	Signal
Reutwurm	Maulwurfsgrille
Revalierungsklage	Klage
Revestiarium	Ankleideraum
Rhabdomantie	Wahrsagung
Rheineck	Schloß
Rheinfels	Schloß
Rheinischer Städtebund	Bündnis
Rheinkiesel	Bergkristall
Rheinstein	Schloß
Rhombus	Parallelogramm
Rhyolith	Liparit
Riccoboni	Reformator
Riechbein	Siebbein
Riedhuhn	Wasserralle
Riementrieb	Triebwerk
Riesenmöwe	Mantelmöwe
Rietz	Geliebte
Rigaischer Meerbusen	Busen
Rindenlaus	Blutlaus
Ringelmeise	Blaumeise
Ringelspinner	Raupe
Rio Lesseps	Nebenfluß
Rippespeer	Rippenstück
Ritter	Krieger
Rizzio	Vertrauter
Roca	Präsident
Rogate	Sonntag
Rohbau	Bauweise
Rohilkhand	Division
Rohrkarpfen	Aland
Rohrspatz	Feldsperling
Römerbrief	Brief
Rondel	Bastion
Rosmer	Pseudonym
Roßhaar	Schweif
Pellegrino Rossi	Jurist
Roßschweif	Abzeichen
Roßtrappe	Granitfels
Rotammer	Zippammer
Rotbart	Beiname
Rotbläßchen	Teichhuhn
Rotkohle	Holzkohle
Rotspecht	Buntspecht
Rottgans	Ringelgans
Rottier	Rotwild
Rotunde	Rundbau
Rotziemer	Rotdrossel
Round Heads	Spottname
Ruaha	Nebenfluß
Rubeen	Abteilung
Rübezahl	Berggeist
Rubico	Grenzfluß
Rücksteuer	Erstattung
Rückversicherung	Versicherung
Ruda	Goldbergwerk
Rudelsburg	Burgruine
Rudenz	Schlößchen
Rudersport	Rudern
Ruin	Trümmer
Ruminantia	Wiederkäuer
Rumpfparlament	Spottname
Run	Ansturm
Rundmäuler	Unterklasse
Runkelstein	Burgruine
Ruptur	Zerreißung
Rupununi	Weißer
Rurik	Gründer
Russische Reichsbank	Staatsbank
Russischer Knöterich	Vogelknöterich
Ruvu	Quellfluß
Ruwu	Quellfluß
Saalach	Salzburger
Säbel	Hiebwaffe
Sabes	Präsident
Sables d´Olonnes	Seebad
Sachsengängerei	Abwanderung
Sadebaum	Strauch
Sadismus	Marquis
Sajama	Vulkan
Sala	Nebenfluß
Salbuch	Verzeichnis
Salem	Ortsname
Salève	Bergrücken
Saliva	Speichel
Saltation	Tanzen
Saltenfjord	Fjord
Salto	Salto
Salzburg	Kronland
Samaniden	Dynastie
Samaritaner	Bewohner
Samenstränge	Samenleiter
Samûm	Wüstensturm
Sand	Pseudonym
Sandale	Fußbekleidung
Sandhafer	Grasart
Sandhühnchen	Flußregenpfeifer
Sandschlangen	Bewohner
Sangay	Vulkan
Sanitätsamt	Behörde
San Marino	Republik
San Marte	Pseudonym
Sarda	Nebenfluß
Sardschu	Nebenfluß
Saronischer Meerbusen	Meerbusen
Sarraß	Säbel
Sasau	Nebenfluß
Satladsch	Nebenfluß
Saturnischer Vers	Versmaß
Saumtier	Maultier
Säurewecker	Reinzucht
Savannah	Grenzfluß
Saxo	Schreiber
Scapula	Schulterblatt
Scarabaeus	Käfer
Scarpe	Nebenfluß
Scefi	Stifterin
Schacharit	Morgengebet
Schadenersatz	Entschädigung
Schalenkrebse	Unterabteilung
Schanstaaten	Staatengebilde
Scharade	Umschreibung
Scharfrichter	Vollstrecker
Scharlachberger	Rheinwein
Schaschka	Säbel
Schatulle	Kästchen
Scheherezade	Märchenerzählerin
Schenkung	Hingabe
Scherbenkobalt	Arsen
Scheschuppe	Grenzfluß
Scheunenkauz	Steinkauz
Schichtmeister	Rechnungsführer
Schieferung	Absonderung
Schießleinen	Leinen
Schießpulver	Holzkohle
Schießräder	Lafette
Schiff Argo	Sternbild
Schiffsgeschütze	Bewaffnung
Schiffsgläubiger	Gläubiger
Schiffsklassifikation	Feststellung
Schildhahn	Birkhahn
Schilfmeise	Bartmeise
Schillerpreis	Ehrenpreis
Schillerstiftung	Stiftung
Schilluh	Berberstamm
Schimla	Gesundheitsstation
Schinderhannes	Anführer
Schirwa	Binnensee
Schlachtensee	Villenkolonie
Schläger	Rapier
Schlämmen	Operation
Schleimgärung	Umwandlung
Schleuder	Wurfwaffe
Schlierbach	Pseudonym
Schmierkur	Behandlung
Schmirgel	Dotterblume
Schmutzgeier	Aasgeier
Schnabel	Pseudonym
Schnarre	Misteldrossel
Schneckenschnitt	Teilung
Schneekönig	Zaunkönig
Schneekrähe	Alpenkrähe
Schneevogel	Schneeammer
Scholárch	Aufsichtsbehörde
Schongauer	Maler
Schopflerche	Haubenlerche
Schopfmeise	Haubenmeise
Schöppen	Kollegium
Schout	Vorstand
Schreckhorn	Kleines
Schriftgelehrte	Sammler
Schriftgießerei	Herstellung
Schröter	Hirschkäfer
Schrötling	Metallplatte
Schtschedrin	Pseudonym
Schuldschein	Bekenntnis
Schutzpatrone	Schutzheilige
Schwäbisches Meer	Bodensee
Schwängerungsklage	Klage
Schwarz	Franziskanermönch
Schwarzburg	Prinz
Schwarzburgbund	Kartell
Schwarze Blattern	Schwarze
Schwarzer Prinz	Prinz
Schwarzhäher	Tannenhäher
Schwarzkopf	Mönchsgrasmücke
Schwarzort	Kirchdorf
Schwarzplättchen	Mönchsgrasmücke
Schwarzschnepfe	Sichler
Schweidnitzer Gebirge	Berglandschaft
Schweißbläschen	Hautausschlag
Schweizerdegen	Drucker
Schweizerhalle	Solbad
Schweizerpillen	Bitterklee
Schwerhörigkeit	Abschwächung
Schwimmnatter	Ringelnatter
Schwingkölbchen	Hinterflügel
S.C.L.	Student
Scrotum	Hodensack
Sebulon	Ahnherr
Seeamsel	Ringdrossel
Seefahrtsbuch	Ausweis
Seekiefer	Schwarz
Seekrebs	Hummer
Seepolyp	Polyp
Seerabe	Tölpel
Seescharbe	Krähenscharbe
Seespecht	Eisvogel
Seeversicherung	Versicherung
Segelsport	Ausübung
Seiltrieb	Triebwerk
Sekretär	Schriftführer
Sekundieren	Beistand
Sekundiz	Feier
Selbstschuldner	Bürge
Selensilber	Selen
Selletgeschirr	Pferdegeschirr
Semasiologie	Bedeutungslehre
Semendria	Festung
Semien	Alpenlandschaft
Send	Heilige
Senne	Senner
Sense	Zufluß
Separator	Zentrifuge
Septisch	Fäulnis
Serapeum	Tempel
Serinette	Drehorgel
Serubabel	Führer
Serviten	Diener
Servus	Knecht
Seth	Ahnherr
Sette Comuni	Berglandschaft
Sexagesimaleinteilung	Einteilung
Sextus	Gesetzbuch
Siamesen	Bewohner
Sichte	Handgerät
Siegel Salomos	Orden
Sienkiewicz	Pseudonym
Signalement	Beschreibung
Signatär	Unterzeichner
Signet	Handzeichen
Sijahposch	Bewohner
Sikuler	Bewohner
Sindh	Division
Singularsukzession	Rechtsnachfolge
Sinolog	Kenner
Sio	Abfluß
Sîpet	Waffe
Sizilianische Vesper	Volksaufstand
Skagerrak	Meeresarm
Skandal	Anstoß
Skeptizismus	Gewißheit
Sklerometer	Apparat
Skrubber	Apparat
Sloe	Meeresarm
Smith	Stifter
Sobránje	Versammlung
Sokratiker	Schüler
Sole	Auflösung
Solent	Meeresarm
Solis	Holzschneider
Son	Nebenfluß
Sonnenbäder	Bestrahlung
Sonnenstein	Irrenanstalt
Sonnenstrahlung	Zufuhr
Sonntagsbuchstabe	Buchstabe
Sorbet	Limonade
Sorel	Geliebte
Soter	Beiname
Souffleur	Person
Sourdine	Dämpfer
Souvenir	Geschenk
Souverain	Goldmünze
Spala	Jagdschloß
Spaniel	Hunderasse
Spanne	Raupe
Spartacus	Anführer
Speaker	Vorsitzende
Species	Erzählung
Spencergewehr	Repetiergewehr
Speziestaler	Taler
Sphingiden	Schwärmer
Sphinkter	Schließmuskel
Sphinxhaube	Kopfbedeckung
Spiegelente	Krickente
Spiegelhuhn	Birkhuhn
Spielhuhn	Birkhuhn
Spinola	Marchese
Spiräen	Abteilung
Spiritusfabrikation	Herstellung
Spitz	Hunderasse
Louis Spohr	Komponist
Sporn	Orden
Staar	Vogel
Staatsbankrott	Weigerung
Staatsgerichtshof	Gerichtshof
Staatsstreich	Gewaltakt
Stabat mater	Mutter
Stachelhummer	Languste
Stachelschwänze	Pflanzen
Staffelrechnung	Zinsrechnung
Standaert	Beiname
Standard Hill	Hügel
Stanzmaschine	Maschine
Starbuckinsel	Lagune
Statthalter	Stellvertreter
Steiermark	Kronland
Stelze	Bachstelze
Stereometer	Apparat
Sternhai	Glatthai
Sternum	Brustbein
Stethograph	Apparat
Steuervergehen	Vergehen
Stichometrie	Zählen
Stilétt	Dolch
Stollenrösche	Graben
Stoppen	Schiffsmaschine
Störtebeker	Anführer
Stößer	Hühnerhabicht
Stradivari	Schüler
Stramonium	Artname
Strandelster	Austernfischer
Strandpfeifer	Flußregenpfeifer
Straß	Mainzer
Strebepfeiler	Pfeiler
Streikversicherung	Versicherung
Streitaxt	Hiebwaffe
Streitvogel	Kampfläufer
Stricken	Herstellung
Strumpf	Glühkörper
Stuprum	Entehrung
Subversion	Umsturz
Südchinesisches Meer	Randmeer
Sühne	Aussöhnung
Suidas	Verfasser
Sulamith	Mädchen
Sumpfeule	Sumpfohreule
Süntel	Bergrücken
Suspensorium	Binde
Synäresis	Zusammenziehung
Synästhesie	Mitempfindung
Synechie	Verwachsung
Synkópe	Ausstoßung
Tabakskollegium	Abendgesellschaft
Tagale	Berglandschaft
Tagsatzung	Versammlung
Tai-hu	Binnensee
Taktvorzeichnungen	Zahlen
Tale-sap	Binnensee
Talion	Strafe
Talisman	Besitzer
Talje	Flaschenzug
Tallapoosa	Quellfluß
Talmud	Gesetzbuch
Talus	Sprungbein
Tamatave	Handelszentrum
Tambo	Quellfluß
Tampon	Bausch
Tan	Pseudonym
Tandem	Pseudonym
Tangentenbussole	Apparat
Tannhäuser	Ritter
Tara	Quellfluß
Tarasca	Volksstamm
Tarif	Verzeichnis
Tasto solo	Taste
Tatarka	Tschapka
Taten	Völkerschaft
Taubenfalk	Hühnerhabicht
Taubenstößer	Hühnerhabicht
Täufer	Wiedertäufer
Taumesser	Apparat
Taurische Göttin	Beiname
Tausch	Veräußerung
Taylor	Pseudonym
Zachary Taylor	General
Teerbutt	Flunder
Teerjacke	Spitzname
Teichwirtschaft	Benutzung
Teilleistung	Erfüllung
Teleologie	Erklärung
Telephon	Apparat
Tempeln	Hasardspiel
Templeisen	Ritter
Tenampua	Pueblo
Tenasserim	Division
Tenby	Seebad
Tenneberg	Schloß
Tenoríst	Sänger
Tera	Tempel
Terborch	Schöpfer
Tergiversieren	Winkelzüge
Terror	Vulkan
Tertia	Schulklasse
Tesching	Handfeuerwaffe
Testamént	Erklärung
Testamént	Letzter
Testikeln	Hoden
Tetartoëdrie	Auftreten
Thaïs	Geliebte
Thalassotherapie	Behandlung
Thales	Stifter
Thallophyten	Abteilung
Thebaner	Bewohner
Theramenes	Publizist
Therapeutisch	Therapie
Thermotherapie	Behandlung
Thëurgie	Zauberkunst
Theußerbad	Mineralbad
Thlinkiten	Indianerstamm
Thraker	Bewohner
Tiara	Kopfbedeckung
Tierwolf	Luchs
Tikal	Münze
Timpanagossee	Süßwassersee
Tirol	Schloß
Toda	Hirtenvolk
Tonalepaß	Alpenpaß
Tonus	Spannung
Töpferkunst	Herstellung
Töpferware	Tonware
Topographie	Beschreibung
Toppsoffizier	Seeoffizier
Torelli-Torriani	Pseudonym
Torf	Aggregat
Tornado	Windstoß
Torpedowesen	Zusammenfassung
Torsion	Drehung
Tosanlysu	Quellfluß
Toskische Sprache	Mundart
Totenamt	Gottesdienst
Toteneule	Steinkauz
Tötung	Herbeiführung
Trachea	Luftröhre
Trance	Entrückung
Tränenschwamm	Hausschwamm
Transformator	Apparat
Transsudation	Absonderung
Trapez	Viereck
Trappgans	Großtrappe
Trappisten	Orden
Trasteveriner	Bewohner
Trente-et-un	Hasardspiel
Tresa	Abfluß
Triade	Zusammenstellung
Triasformation	Kalkstein
Tribonianus	Vorsitzender
Tribrachys	Versfuß
Trikolore	Nationalflagge
Triole	Tonfigur
Trochanter	Rollhügel
Trochäus	Versfuß
Trödelhandel	Handel
Troglodytes	Gattungsname
Trollhätta	Wasserfall
Tromlitz	Pseudonym
Tromper Wiek	Meerbusen
Trossenschlag	Anfertigung
Trubia	Eisenhütte
Trustee	Bevollmächtigter
Tschambesi	Quellfluß
Tschinównik	Inhaber
Tschuapa	Nebenfluß
Tschuktschen	Völkerschaft
Tuareg	Bewohner
Tunguragua	Vulkan
Tungusen	Volksstamm
Turban	Kopfbedeckung
Turmeule	Schleiereule
Turmkrähe	Dohle
Turpin	Erzbischof
Tuscarora	Kriegsschiff
Tüte	Goldregenpfeifer
Tutor	Professor
Tütvogel	Goldregenpfeifer
Tweed	Grenzfluß
Tzimiskes	Beiname
Überversicherung	Versicherung
Udinen	Volksstamm
Uferspecht	Eisvogel
Uffizien	Palast
Ujesd	Unterabteilung
Ultimus	Letzte
Unam sanctam	Bulle
Union Deutsche Verlagsgesellschaft	Verlagsbuchhandlung
Upstallsbom	Hügel
Uranienborg	Schloß
Urá-tjube	Festung
Ureter	Harnleiter
Urft	Talsperre
Urhuhn	Auerhuhn
Urtlan	Gartenammer
Usa	Lippenbär
Uskoken	Bewohner
Usufruktuar	Nutznießer
Uticénsis	Beiname
Utriusque juris doctor	Doktor
Vaiçya	Handwerker
Valbert	Pseudonym
Vale	Abschied
Vandiemensgolf	Einbuchtung
Varangerfjord	Meerbusen
Variatio delectat	Abwechslung
Variolith	Diabas
Vatatzes	Kaiser
Velebit	Bergrücken
Velhagen & Klasing	Verlagsbuchhandlung
Velodrom	Rennbahn
Vely	Pseudonym
Ventre à terre	Bauch
Verdingung	Abschließung
Vergiftung	Beibringung
Verhau	Strauchwerk
Verjährung	Erwerbung
Verpuppung	Verwandlung
Vertigo	Schwindel
Vertragsbruch	Nichterfüllung
Verwaltungsgerichtsbarkeit	Gerichtsbarkeit
Verzug	Verzögerung
Vesta	Göttin
Vesullian	Schichtenfolge
Vexillum	Fahne
Vicelinus	Apostel
Vieweg	Verlagsbuchhandlung
Vikar	Stellvertreter
Villa Viçosa	Orden
Vingt-et-un	Hasardspiel
Violoncello	Cello
Virginische Nachtigall	Kardinal
Visaya	Volksstamm
Viskosimeter	Apparat
Vivisektion	Vornahme
Vizedeckoffiziere	Reserveoffizier
Vleet	Treibnetz
Voirons	Bergrücken
Volkusen	Seeskorpion
Vorderrhein	Quellfluß
Vorhalt	Verzögerung
Vorparlament	Versammlung
Vorwärmer	Apparat
Vulgivaga	Beiname
Wachsamkeit	Orden
Wachsmalerei	Herstellung
Wadenkrampf	Zusammenziehung
Wadhwan	Vasallenstaat
Wadschagga	Bevölkerung
Waganda	Bewohner
Wagel	Mantelmöwe
Wagenwinde	Maschine
Waghäusel	Zuckerfabrik
Wagogo	Bewohner
Wagram	Fürst
Wahehe	Bewohner
Wahha	Bewohner
Wahnfried	Villa
Wakami	Bewohner
Wakenitz	Abfluß
Wakutu	Bewohner
Wakwere	Bewohner
Walchensee	Alpensee
Waldemmerling	Zaunammer
Waldhäher	Eichelhäher
Waldkater	Rotkopfwürger
Waldkatze	Wildkatze
Waldsänger	Dorngrasmücke
Waldtaube	Ringeltaube
Waldteufel	Zwergohreule
Waldus	Gründer
Walen	Bewohner
Wales	Prinz
Walfischgewehr	Hinterlader
Wali	Vorsteher
Walliser	Bewohner
Walmiki	Verfasser
Walzer	Rundtanz
Wandlungsklage	Klage
Wang	Kirche
Wanjoro	Bewohner
Wappenbrief	Urkunde
Wara	Nashorn
Waragal	Dingo
Warmbad	Militärstation
Warnicken	Oberförsterei
Wartezeit	Trauerjahr
Warundi	Bewohner
Wasagara	Bewohner
Wasambara	Bewohner
Wasaramo	Bewohner
Waschamba	Bewohner
Wäscher	Apparat
Wasegua	Bewohner
Wash	Busen
Wassambi	Bewohner
Wasserdrossel	Wasseramsel
Wasserelster	Austernfischer
Wasserfall	Absturz
Wasserkissen	Kissen
Wasserlerche	Wasserpieper
Wasserpolaken	Flößer
Wasserspecht	Eisvogel
Wasserwanzen	Unterabteilung
Wassukuma	Bewohner
Wate	Vasall
Waterländer	Partei
Watt	Verbesserer
Wat Tyler	Ziegelbrenner
Wavinsa	Bewohner
Wawel	Anhöhe
Weberei	Herstellung
Weberfisch	Gründling
Wechselschluß	Vertrag
Wegmesser	Apparat
Weibertreu	Burgruine
Weichdorn	Kreuzdorn
Weilburg	Schloß
Weinmotte	Traubenwickler
Weinpalme	Palmwein
Weinschwärmer	Schwärmer
Weinstockrüsselkäfer	Rebenstecher
Weisel	Bienenkönigin
Weissagung	Verkündigung
Weißdornspinner	Goldafter
Weißes C	Tagfalter
Weißes Haus	Amtswohnung
Weißes Meer	Busen
Weißhuhn	Moorhuhn
Weißtanne	Edeltanne
Weißwasser	Quellfluß
Welscher Hahn	Truthahn
Wendepflug	Pflug
Werkverdingung	Vertrag
Werth	General
John Wesley	Stifter
Wessel	Vorläufer
Westerplatte	Seebad
Wetterkanone	Apparat
Wheatstonesche Brücke	Apparat
Whipper-in	Einpeitscher
Whiteboys	Geheimbund
White River	Weißer
Wiener Kalk	Schlämmkreide
Wigalois	Ritter
Wigalois	Ritter
Wigwam	Hütte
Wildente	Stockente
Wildkuh	Säbelantilope
Wildstrubel	Alpengipfel
Willebrord	Apostel
Willegis	Erzbischof
Wimperinfusorien	Unterklasse
Wimpina	Gegner
Windharmonika	Harmonika
Winkelschriftstellerei	Anfertigung
Winterling	Grauammer
Wirbelkäfer	Taumelkäfer
Witboi	Häuptling
Wittdün	Seebad
Wittinnen	Flußschiffahrt
Witu	Küstenlandschaft
Witwe	Ehefrau
Wladímir Alexándrowitsch Großfürst von Rußland	Großfürst
Wladímirbai	Busen
Wocheiner See	Alpensee
Wohnungsgeldzuschuß	Zuschuß
Wolchow	Abfluß
Wollspinnerei	Verarbeitung
Wolsey	Erzbischof
Wörterbuch	Enzyklopädie
Wotjáken	Kasan
Woulfesche Flasche	Glasflasche
Wruke	Kohlrübe
Wühlente	Brandgans
Wuoksen	Abfluß
Würderungsklage	Klage
Würm	Abfluß
Württemberg	Prinz
Xenios	Beiname
Xenophanes	Stifter
Yale-Universität	Universität
Yorick	Pseudonym
Brigham Young	Oberhaupt
Yunka	Urbewohner
Zahnrichtung	Regulierung
Zähpolen	Raffinieren
Zähringen	Ruine
Zängen	Operation
Zangenoperation	Entbindung
Zapfenwickler	Rebenstecher
Zapoteken	Indianervolk
Zäsalpiniazeen	Abteilung
Zaunkirsche	Heckenkirsche
Zehn Gebote	Dekalog
Zeidlerei	Bienenzucht
Zelandus	Pseudonym
Zelliten	Beiname
Zentrifugalmaschine	Apparat
Zenturie	Abteilung
Zession	Abtretung
Zeugdruck	Herstellung
Zeugnisverweigerung	Weigerung
Ziffern	Schriftzeichen
Zinkdruck	Druckverfahren
Zinkgießerei	Herstellung
Zinngießerei	Herstellung
Zirkumzellionen	Partei
Zitrullengurke	Wassermelone
Zokor	Blindmaus
Zollkredit	Stundung
Zolltarif	Verzeichnis
Zoolog	Zoologie
Zoolog	Kenner
Zoomagnetismus	Magnetismus
Zug	Unterabteilung
Zuidersee	Meerbusen
Zwangsjacke	Jacke
Zweihufer	Wiederkäuer
Zwergameisenfresser	Ameisenbär
Zwergreicher	Rohrdommel
Zyklische Dichter	Dichter
Zyniker	Spottname
Bergbau	Kupfer
