Aberdare	Wales
Aberystruth	Wales
Accrington	Lancaster
Aelst	Ostflandern
Ahmadnagar	Bombay
Aïntâb	Haleb
Akita	Japan
Akjab	Birma
Akkermán	Bessarabien
Akron	Ohio
Alcoy	Alicante
Aldershot	Hampshire
Allentown	Pennsylvanien
Altenburg	S.-Altenburg
Altoona	Pennsylvanien
Andidschan	Ferghana
Andria	Bari delle Puglie
Angoulême	Charente
Appenzell	Schweiz
Arequipa	Peru
Arnheim	Geldern
Arrah	Bengalen
Ashton-under-Lyne	Lancaster
Asnières	Seine
Asti	Alessandria
Aubervilliers	Seine
Auburn	Neuyork
Avignon	Vaucluse
Ballarat	Victoria
Barferusch	Masenderan
Barnsley	York
Barquisimeto	Venezuela
Barrow-in-Furneß	Lancashire
Bassein	Birma
Bath	Somerset
Batley	York
Bayonne	Neujersey
Bellary	Madras
Bendér	Bessarabien
Bendigo	Victoria
Berdítschew	Kiew
Bern	Bern
Bernburg	Anhalt
Besançon	Doubs
Beuthen.	Oppeln
Béziers	Hérault
Bharotsch	Bombay
Bhiwani	Dehli
Bida	Fulbereichs Nupe
Bielefeld	Minden
Binghamton	Neuyork
Bisceglie	Bari
Bitonto	Bari
Bjelostók	Grodno
Blackpool	Lancaster
Blagowjéschtschensk	Amurgebiet
Bloemfontein	Oranjeflußkolonie
Bobrujsk	Minsk
Bochum	Arnsberg
Bona	Constantine
Bonn	Köln
Bootle	Lancaster
Boulogne-sur-Mer	Pas-de-Calais
Boulogne-sur-Seine	Paris
Brandenburg	Potsdam
Brest-Litowsk	Grodno
Brockton	Massachusetts
Brügge	Westflandern
Budweis	Böhmen
Burslem	Stafford
Burton-upon-Trent	Stafford
Bury	Lancaster
Butte (City)	Montana
Caen	Calvados
Cali	Kolumbien
Cañar	Ecuador
Cannes	Alpes-Maritimes
Canton	Ohio
Carcassonne	Aude
Carlisle	Cumberland
Carrara	Massa e Carrara
Casale Monferrato	Alessandria
Cerignola	Foggia
Cesena	Forlì
Charleston	Südkarolina
Chatham	Kent
Chattanooga	Tennessee
Chaux-de-Fonds	Neuenburg
Chelsea	Massachusetts
Cheltenham	Gloucester
Cherbourg	La Manche
Chester	Cheshire
Chillán	Ñuble
Chioggia	Venedig
Chivilcoy	Buenos Aires
Chodschent	Samarkand
Chotin	Bessarabien
Cleve	Düsseldorf
Clichy-la-Garenne	Seine
Coatbridge	Lanark
Cobán	Alta Verapaz
Colchester	Essex
Copparo	Ferrara
Corato	Bari
Cottbus	Frankfurt
Covington	Kentucky
Crajova	Kreises Doljiu
Creusot	Saône-et-Loire
Crewe	Cheshire
Czenstóchau	Petrikau
Czernowitz	Bukowina
Dallas	Texas
Damiette	Unterägypten
Danapur	Bengalen
Darbhanga	Patna
Darlington	Durham
Darwen	Lancaster
Davenport	Jowa
Delft	Südholland
Dessau	Anhalt
Deutsch-Wilmersdorf	Potsdam
Diamantïna	Minas Geraes
Dordrecht	Südholland
Dorpat	Livland
Dover	Kent
Dschhansi	Allahabad
Dubuque	Jowa
Dudley	Worcester
Duluth	Minnesota
Dünkirchen	Nord
Durban	Kolonie Natal
Ealing	Middlesex
Eastbourne	Sussex
Eccles	Lancaster
Ecclesfield	York
Edessa	Mesopotamien
Edmonton	Middlesex
Eisenach	S.-Weimar
Elbing	Danzig
Elizabeth	Neujersey
Elmira	Neuyork
Eluru	Madras
Emesa	Cölesyrien
Enfield	Middlesex
Erie	Pensylvanien
Evansville	Indiana
Exeter	Devon
Faënza	Ravenna
Farruchabad	Vereinigten Provinzen von Agra und Oudh
Firozpur	Lahaur
Fitchburg	Massachusetts
Flensburg	Schleswig
Floridsdorf	Niederösterreich
Folkestone	Kent
Fort Wayne	Indiana
Freetown	Westafrika
Fünfkirchen	Komitats Baránya
Fürth	Mittelfranken
Galatz	Rumänien
Galveston	Texas
Georgetown	Brit.-Guayana
Ghasipur	Benares
Gijón	Oviedo
Gillingham	Kent
Gladbach	Düsseldorf
Glarus	Schweiz
Gleiwitz	Oppeln
Gomel	Mogilew
Great Grimsby	Lincoln
Great Yarmouth	Norfolk
Greenock	Renfrew
Grenoble	Isère
Großwardein	Bihár
Guayaquil	Guayas
Guben	Frankfurt
Haarlem	Nordholland
Hagen	Arnsberg
Hamah	Syrien
Hamilton	Lanark
Hamm	Arnsberg
Handsworth	Stafford
Hanley	Stafford
Harborne	Stafford
Harrisburg	Pennsylvanien
Hastings	Sussex
Hirosaki	Mutsu
Hobart	Kolonie Tasmanien
Hoboken	Neujersey
Hodeïda	Jemen
Hódmezö-Vásárhely	Csongrád
Hohenstein	Erfurt
Holbeck	York
Holyoke	Massachusetts
Honolulu	Sandwichinseln
Houston	Texas
Hove	Sussex
Hubli	Bombay
Hyde	Chester
Imola	Bologna
Imoski	Dalmatien
Ipswich	Suffolk
Iquique	Tarapaca
Isleworth	Themse
Ismaïl	Bessarabien
Itawa	Agra
I-tschang	Hu-pe
Jaffa	Jerusalem
Jakoba	Bautschi
Jarrow	Durham
Jejsk	Kubangebiet
Jekaterinburg	Perm
Jekaterinodár	Kubangebiet
Jeléz	Orel
Jelisawetgrád	Cherson
Jerez de la Frontera	Cádiz
Jésd	Irak-Adschmi
Johnstown	Pennsylvanien
Kadiköi	von Skutari
Kagoshima	Satsuma
Kakinada	Madras
Kamenéz-Podolsk	Podolien
Kamthí	Zentralprovinzen
Kandahar	Afghanistan
Karschi	Zentralasien
Kaschau	Komitats Abauj-Torna
Katak	Bengalen
Katmandu	Vorderindien
Kecskemét	Komitat Pest
Keighley	York
Kerbela	Wilajet Bagdad
Kermanschah	Ardilan
Kilmarnok	Ayr
King's Norton and Northfield	Worcester
Kingston-upon-Thames	Surrey
Kiu-kiang	Kiang-si
Knoxville	Tennessee
Kojambatur	Madras
Kolomea	Galizien
Königliche Weinberge	Böhmen
Kortrijk	Westflandern
Koslów	Tambow
Krasnojársk	Jenisseisk
Krementschúg	Poltawa
Kronstadt	Petersburg
Kudalur	Madras
Kuku-chota	der Mongolei
Kumase	Aschanti
Kumb(h)akonam	Tandschur
Kusch-Adassi	Aïdin
Lausanne	Waadt
Laval	Mayenne
Lavaletta	Malta
Lawrence	Massachusetts
Leeuwarden	Friesland
Leiden	Südholland
Leigh	Lancaster
Lekemti	Abessiniens
Liau-jang	Scheng-king
Libau	Kurland
Linares	Jaén
Línea	Cádiz
Little Rock	Arkansas
London	Ontario
Longton	Stafford
Lorca	Murcia
Lorient	Morbihan
Löwen	Brabant
Luang-Prabang	Laos
Ludhiana	Pandschab
Lugánsk	Jekaterinoslaw
Luton	Bedford
Maastricht	Limburg
Macclesfield	Chester
MacKeesport	Pennsylvanien
Mährisch-Ostrau	Mähren
Maidstone	Kent
Majkop	Kubangebietes
Makó	Csanád
Malden	Massachusetts
Malmen	Tenasserim
Manáos	Amazonas
Manchester	Neuhampshire
Mangalur	Madras
Manissa	Aïdin
Mans	Sarthe
Mansurah	Dachalieh
Maracaibo	Zulia
Marasch	Haleb
Margelán	Ferghana
Mariupól	Jekaterinoslaw
Maskât	Nordostküste Arabiens
Masulipatam	Madras
Mathura	Vereinigten Provinzen
Mecheln	Antwerpen
Medellin	Antioquia
Medînet el-Fajûm	Fajûm
Mehallet el-Kebir	Gharbieh
Mekines	Innern von Marokko
Merthyr Tydfil	Wales
Mhau	Vasallenstaat Indaur
Miskolcz	Komitats Borsod
Mitau	Kurland
Mobile	Alabama
Modschi	Ken Fukuoka
Molfetta	Bari
Monterey	Nuevo León
Montgomery	Alabama
Montluçon	Allier
Montreuil-sous-Bois	Seine
Monza	Mailand
Morelia	Michoacán
Morioka	Ken Iwate
Motherwell	Lanark
Mountain Ash	Wales
Mungir	Bhagalpur
Muzaffarpur	Bengalen
Namangán	Ferghana
Negapattan	Madras
Nellur	Madras
Neuilly-sur-Seine	Seine
New Bedford	Massachusetts
Newton	Massachusetts
Ngan-king	Ngan-hwei
Nictheroy	Rio de Janeiro
Niigata	von Nippon
Nimwegen	Geldern
Njeshin	Tschernigow
Norrköping	Östergötland
Nowotscherkáßk	Donischen Kosaken
Nyiregyháza	Komitats Szabolcs
Odense	Insel Fünen
Omderman	Sudan
Omsk	Russ.-Zentralasien
Orizaba	Veracruz
Orléans	Loiret
Ostende	Westflandern
Ouro Preto	Minas Geraes
Pachuca	Hidalgo
Palamkotta	Madras
Palghat	Madras
Palmas	Gran Canaria
Pandharpur	Bombay
Partick	Lanark
Patras	Nomos Achaia
Pau	Basses-Pyrénées
Pawtucket	Rhode Island
Peiraieus	Nomos Attika
Peoria	Illinois
Périgueux	Dordogne
Perpignan	Pyrénées-Orientales
Peterborough	Northampton
Pe-tu-na	Kirin
Pietermaritzburg	Südostafrika
Pilsen	Böhmen
Pistoja	Florenz
Ploësci	Prahova
Pnom-penh	Hinterindien
Poitiers	Poitou
Pola	Istrien
Pontypridd	Wales
Port-au-Prince	Haïti
Port Elizabeth	Kapkolonie
Portland	Maine
Port Louis	Mauritius
Port of Spain	Trinidad
Porto Novo	Westafrika
Port Saïd	Ägypten
Prato	Florenz
Pretoria	Transvaalkolonie
Prizren	Wilajets Kosovo
Przemysl	Galizien
Puri	Orissa
Quincy	Illinois
Rawtenstall	Lancaster
Reichenberg	Böhmen
Rescht	Gilan
Reval	Meerbusens
Rimini	Forlì
Roanne	Loire
Rochefort	Charente-Inférieure
Rochelle	Charente-Inférieure
Rochester	Kent
Rockford	Illinois
Rotherham	York
Rowley Regis	Stafford
Rshew	Twer
Saga	Hizen
Sagasik	Schârkieh
Saginaw	Michigan
Saigon	Kotschinchina
Saint-Denis	Seine
Saint-George	Gloucester
Saint John	Neubraunschweig
Saint John's	Neufundland
Saint-Nazaire	Loire-Inférieure
Saint-Nicolas	Ostflandern
Saint-Quentin	Aisne
Salem	Massachusetts
Salt Lake City	Utah
Sanâ	Wilajet Jemen
San Antonio	Texas
San Sebastián	Guipúzcoa
San Severo	Foggia
Santa Ana	Salvador
Santa Cruz de Tenerife	Teneriffa
Saraki	Negerreich Nupe
Savona	Genua
Scarborough	York
Schenectady	Neuyork
Schikarpur	Pandschab
Schirâs	Farsistan
Seraing	Lüttich
Sergijéwskij Possád	Moskau
Simferópol	Halbinsel Krim
Sinj	Dalmatien
Sioux City	Iowa
Smethwick	Stafford
Smichow	Böhmen
South Bend	Indiana
Southport	Lancaster
Spezia	Genua
Spokane Falls	Washington
Springfield	Illinois
Srirampur	Bengalen
Stanislau	Galizien
Stockton upon Tees	Durham
Stoke-upon-Trent	Stafford
Stretford	Lancaster
Swa-tou	Kwang-tung
Swindon	Wiltshire
Sysran	Simbirsk
Szentes	Komitat Csongrád
Taganróg	Donischen Kosaken
Takamatsu	Ken Kagawa
Tammerfors	Tawastehus
Tandschur	Madras
Tanta	Gharbieh
Tarént	Lecce
Tarnopol	Galizien
Tarnów	Galizien
Temesvár	Temes
Terni	Perugia
Terre Haute	Indiana
Therezina	Piauhy
Thorenburg	Siebenbürgen
Tilburg	Nordbrabant
Tintellust	Air
Tipton	Stafford
Tirunelweli	Madras
Tlemsén	Oran
Topeka	Kansas
Torquay	Devonshire
Torre del Greco	Neapel
Tournai	Hennegau
Tours	Touraine
Trani	Bari delle Puglie
Troyes	Champagne
Tugurt	Constantine
Tynemouth	Northumberland
Udschain	Ostindien
Unión	Murcia
Utica	Neuyork
Vercelli	Novara
Versailles	Seine-et-Oise
Verviers	Lüttich
Vittoria	Álava
Wakefield	York
Wallasey	Cheshire
Walton-on-the-Hill	Lancaster
Warrington	Lancaster
Waterbury	Connecticut
Wavertree	Lancaster
Wellur	Karnātak
West Bromwich	Stafford
Wheeling	Westvirginia
Wilkesbarre	Pennsylvanien
Wimbledon	Surrey
Winnipeg	Manitoba
Wínniza	Podolien
Withington	Lancaster
Yonkers	Neuyork
York	Pennsylvanien
Youngstown	Ohio
Zara	Dalmatien
Zarízyn	Saratow
Zizkow	Böhmen
Zwolle	Oberyssel
