Abaddon	hebr.
Abakus	lat.
Abandon	frz.
Abaton	grch.
Abbate	ital.
Abbé	frz.
Abbreviatoren	lat.
Abbreviatur	lat.
Abd	arab.
Abdest	pers.
Abdikation	lat.
Abdomen	lat.
Abduktion	lat.
Abduzieren	lat.
Abhorreszénz	lat.
Abies	lat.
Abigeat	lat.
Abimelech	hebr.
Abiogenesis	grch.
ab irato	lat.
Abituriént	lat.
Abjuration	lat.
Ablaktation	lat.
Ablation	lat.
Ablativ	lat.
Ablegat	lat.
Abnórm	lat.
Abolition	lat.
Abominabel	lat.
Abonnement	frz.
Aboral	lat.
Abortieren	lat.
Abortiva	lat.
Abortus	lat.
Abraham	hebr.
Abrasion	lat.
Abrogieren	lat.
Abrúpt	lat.
Absarii	mittellat.
Absént	lat.
Absit omen	lat.
Absolut	lat.
Absolution	lat.
Absolutismus	neulat.
Absolutorium	lat.
Absolvénten	lat.
Absolvieren	lat.
Absorbieren	lat.
Absorption	lat.
Abstention	lat.
Abstinénz	lat.
Abstractum	lat.
Abstrahieren	lat.
Abstraktion	lat.
Abstrus	lat.
Absúrd	lat.
Abszeß	lat.
Abszisse	lat.
Abû	arab.
Abulie	grch.
Abûnâ	arab.
Abundantia	lat.
Abusio	lat.
Abusiv	lat.
Abyssisch	grch.
Accelerándo	ital.
Accentus ecclesiastici	lat.
Accepi	lat.
Accompagnato	ital.
Accrescendo	ital.
Acer	lat.
Acetum	lat.
Acheiropita	grch.
Acheropita	grch.
Acholie	grch.
Achromatopsie	grch.
Achter	niederd.
Acidum	lat.
Acquit	frz.
Acrania	lat.
Act	engl.
Acta	lat.
Actum	lat.
Aculeus	lat.
Adagio	ital.
Adam	hebr.
Adaptieren	lat.
Adäquat	lat.
Adar	hebr.
Addénda	lat.
Addiktion	lat.
Addition	lat.
Addizieren	lat.
Adduktoren	lat.
Adelaer	holl.
Ademtion	lat.
Adenalgie	grch.
Adépt	lat.
Adhärieren	lat.
Adhäsion	lat.
Adhortation	lat.
Adiabate	grch.
Adiaphon	grch.
Adiaphora	grch.
Ad infinitum	lat.
Adipid	neulat.
Adipocire	frz.
Adjazént	lat.
Adjektiv	lat.
Adjoint	frz.
Adjudikation	lat.
Adjungieren	lat.
Adjustieren	lat.
Adjutánt	lat.
Administration	lat.
Admirabel	lat.
Admissibel	lat.
Ad modum Minellii	lat.
Admonieren	lat.
Adonai	hebr.
Adoptieren	lat.
Adorabel	lat.
Adoral	lat.
Adoration	lat.
Adorieren	lat.
Adoucieren	frz.
Adressánt	frz.
Adresse	frz.
Adrétt	frz.
Adstringieren	lat.
Advaita	sanskr.
Ad valorem	lat.
Advént	lat.
Adverbium	lat.
Adversaria	lat.
Advokat	lat.
Adyton	grch.
Aërobien	grch.
Aërodynamik	grch.
Aërogamen	grch.
Aëroklinoskop	grch.
Aërolithen	grch.
Aëromechanik	grch.
Aëronaut	grch.
Aërophon	grch.
Aërophor	grch.
Aëroplane	frz.
Aërostat	grch.
Aërostatik	grch.
Aërotherapie	grch.
Aërozoen	grch.
Affaldsdynger	dän.
Affékt	lat.
Affektation	lat.
Affektion	lat.
Affettuoso	ital.
Affiche	frz.
Affiliation	lat.
Affinieren	frz.
Affinität	lat.
Affirmation	lat.
Affizieren	lat.
Affluieren	lat.
Affut	frz.
Agapen	grch.
Agates blanches	frz.
Agens	lat.
Agént	lat.
Agentien	lat.
Agglomerat	lat.
Agglutination	lat.
Aggravieren	lat.
Aggregat	lat.
Aggregieren	lat.
Aggression	lat.
Agieren	lat.
Agil	lat.
Agio	frz.
Agiotage	frz.
Agitation	lat.
Agitato	ital.
Agnaten	lat.
Agnoeten	grch.
Agnomen	lat.
Agnostizismus	grch.
Agnoszieren	lat.
Agnus Deï	lat.
Agogik	grch.
Agon	grch.
Agone	grch.
Agonie	grch.
Agoníst	grch.
Agonistiker	grch.
Agora	grch.
Agoraphobie	grch.
Agraffe	frz.
Agreabel	frz.
Agrégé	frz.
Agrést	lat.
Agrikultur	lat.
Agronom	grch.
Agrumi	ital.
Agrypnie	grch.
Agynisch	grch.
Ägyptolog	grch.
Aide	frz.
Aigle	frz.
Aigrette	frz.
Aiguille	frz.
Ailette	frz.
Aïn	arab.
Air	frz.
Aisance	frz.
Ajustieren	frz.
Akademie	grch.
Akademiker	grch.
Akariasis	grch.
Akataléktisch	grch.
Akataphasie	grch.
Akatholiken	grch.
Akephalen	grch.
Akidopeirástik	grch.
Akiurgie	grch.
Akkaparement	frz.
Akklamation	lat.
Akkolade	frz.
Akkolat	lat.
Akkommodation	lat.
Akkommodieren	lat.
Akkompagnement	frz.
Akkórd	frz.
Akkordieren	frz.
Akkouchement	frz.
Akkreditieren	frz.
Akkriminieren	lat.
Akkumulation	lat.
Akkumulatoren	lat.
Akkurat	lat.
Akkusat	lat.
Akkusativ	lat.
Akline	grch.
Akme	grch.
Akne	grch.
Akologie	grch.
Akoluthen	grch.
Akorie	grch.
Akquirieren	lat.
Akratothermen	grch.
Akribie	grch.
Akroamatisch	grch.
Akrobat	grch.
Akrolithen	grch.
Akropolis	grch.
Akrostichon	grch.
Akroterion	grch.
Akt	lat.
Aktie	lat.
Aktinisch	grch.
Aktinograph	grch.
Aktinolith	grch.
Aktinometer	grch.
Aktinomórph	grch.
Aktinomykose	grch.
Aktion	lat.
Aktiv	lat.
Aktiva	lat.
Aktivität	lat.
Aktivum	lat.
Aktrice	frz.
Aktualität	frz.
Aktus	lat.
Akupressur	lat.
Akupunktur	lat.
Akústik	grch.
Akut	lat.
Akyanoblepsie	grch.
Akzedieren	lat.
Akzeleration	lat.
Akzént	lat.
Akzépt	lat.
Akzeptabel	lat.
Akzéß	lat.
Akzession	lat.
Akzéssit	lat.
Akzessorisch	lat.
Akzidens	lat.
Akzidentalen	lat.
Akzidentalien	lat.
Akzidenzien	lat.
Akzipieren	lat.
Alaaf	niederd.
Alalie	grch.
Alárm	frz.
Alarmieren	frz.
Alástor	grch.
Alauda	lat.
Alba	lat.
Albedo	lat.
Albinismus	lat.
Albion	kelt.
Album	lat.
Alcalá	arab.
Alderman	engl.
Aleatorisch	lat.
Alektryomachie	grch.
Alemdar	arab.
Alért	frz.
Aleurometer	grch.
Aleuron	grch.
Alexie	grch.
Alexipharmakon	grch.
Algebra	arab.
Alhidade	arab.
Alias	lat.
Alibi	lat.
Aliënation	lat.
Alignement	frz.
Aliménte	lat.
Aliquid haeret	lat.
Alkóhol	arab.
Alkoven	arab.
Alla breve	ital.
Allantiasis	grch.
Allantois	grch.
Alla prima	ital.
Alla zoppa	ital.
Allegat	lat.
Allegieren	lat.
Allegorie	grch.
Allegraménte	ital.
Allegretto	ital.
Allegro	ital.
Allemande	frz.
Alliance	frz.
Alligation	lat.
Alligieren	lat.
Alliieren	frz.
Alliteration	neulat.
Allochroisch	grch.
Allokution	lat.
Allonge	frz.
Allons!	frz.
Allopathie	grch.
Allotria	grch.
Allüre	frz.
Allusion	lat.
Alluvial	lat.
Alluvion	lat.
Alluvium	lat.
Alma mater	lat.
Al marco	ital.
Almeh	arab.
Almukantharat	arab.
Alnus	lat.
Altan	ital.
Altar	lat.
Altera pars	lat.
Alteration	lat.
Alter ego	lat.
Alterieren	lat.
Alternat	lat.
Alternation	lat.
Alternative	lat.
Alternieren	lat.
Altesse	frz.
Alumen	lat.
Alveole	lat.
Amalgam	arab.
Amanuénsis	lat.
Amateur	frz.
Amaurose	grch.
Ambacht	altd.
Ambassade	frz.
Ambe	lat.
Ambidexter	lat.
Ambieren	lat.
Ambiloquie	lat.
Ambition	lat.
Amblyopie	grch.
Ambrosia	grch.
Ambulánt	lat.
Ambulatorisch	lat.
Amelioration	frz.
Amen	hebr.
Amendement	frz.
Améntum	lat.
Ametrie	grch.
Ametropie	grch.
Ameublement	frz.
Amictus	lat.
Amme	zoolog.
Amnesie	grch.
Amnestie	grch.
Amnion	grch.
Amöbäisch	grch.
Amön	lat.
Amorces	frz.
Amoroso	ital.
Amórph	grch.
Amorphozoa	grch.
Amortisation	mittellat.
Amovibel	lat.
Amphi...	grch.
Amphibolie	grch.
Amphibrachys	grch.
Amphicöl	grch.
Amphimacer	grch.
Amphiprostylos	grch.
Amphitheater	grch.
Amphoter	grch.
Amplifikation	lat.
Amplitüde	frz.
Ampulla	lat.
Amputation	lat.
Ämulation	lat.
Amulétt	arab.
Amusette	frz.
Amusie	grch.
Amüsieren	frz.
Ana	grch.
Anabasis	grch.
Anabiose	grch.
Anachoreten	grch.
Anachronismus	grch.
Anadyoméne	grch.
Anaglyphe	grch.
Anagnost	grch.
Anagoge	grch.
Anagrámm	grch.
Anakrusis	grch.
Analekten	grch.
Analemma	grch.
Analeptika	grch.
Analog	grch.
Analogon	grch.
Analphabeten	grch.
Analysieren	grch.
Analytik	grch.
Analytisch	grch.
Anämie	grch.
Anamnese	grch.
Anamorphose	grch.
Anapäst	grch.
Anaplástik	grch.
Anarchie	grch.
Anasarka	grch.
Anastaltika	grch.
Anastase	grch.
Anastatisch	grch.
Anästhesie	grch.
Anastomose	grch.
Anathem	grch.
Anatomie	grch.
Anatozismus	grch.
Anceps	lat.
Anchylosis	grch.
Andante	ital.
Androgynie	grch.
Andromanie	grch.
Androphobie	grch.
Andrözeum	grch.
Anéantieren	frz.
Anekdota	grch.
Anemograph	grch.
Anerythropsie	grch.
Aneurýsma	grch.
Angelica salutatio	lat.
Angelolatrie	grch.
Angelologie	grch.
Angelophanie	grch.
Angelus	lat.
Angiëktasie	grch.
Angina	lat.
Angiographie	grch.
Angiokárp	grch.
Angiologie	grch.
Angiom	grch.
Angioneurose	grch.
Angiosarkom	grch.
Angiostenose	grch.
Anglasie	frz.
Anglia	lat.
Anguis	lat.
Anhidrosis	grch.
Anhydrid	grch.
Anil	lat.
Animalisation	lat.
Animieren	lat.
Animos	lat.
Animoso	ital.
Anisfett	frz.
Anisometropie	grch.
Ankylometer	grch.
Ankylose	grch.
Annalen	lat.
Annaten	lat.
Annektieren	lat.
Annéx	lat.
Annexion	lat.
Anni climacterici	lat.
Anni currentis	lat.
Annihilation	lat.
Anniversarium	lat.
Anno	lat.
Annonce	frz.
Annotata	lat.
Annuale	lat.
Annuarium	neulat.
Annuieren	lat.
Annullation	lat.
Annunziation	lat.
Annus	lat.
Anode	grch.
Anodyna	grch.
Anogen	grch.
Anomal	grch.
Anomalie	grch.
Anomodónten	grch.
Anonym	grch.
Anorganisch	grch.
Anorthoskop	grch.
Anosmie	grch.
Antagoníst	grch.
Antaphrodisiaka	grch.
Antarktisch	grch.
Ante...	lat.
Antedatieren	lat.
Ante diëm	lat.
Antediluvianisch	lat.
Anteflexion	lat.
Anteludium	lat.
Antelukanisch	lat.
Antemundan	lat.
Anten	lat.
Antennen	lat.
Antependium	lat.
Antepenultima	lat.
Antezedenz	lat.
Anthem	engl.
Anthemion	grch.
Anthere	grch.
Antheridien	grch.
Anthesterien	grch.
Anthologie	grch.
Anthophyllen	grch.
Anthraknose	grch.
Anthrakometer	grch.
Anthrakose	grch.
Anthrakotypie	grch.
Anthrax	grch.
Anthropogenie	grch.
Anthropogeographie	grch.
Anthropolatrie	grch.
Anthropolithen	grch.
Anthropologie	grch.
Anthropometrie	grch.
Anthropomórphen	grch.
Anthropomorphísmus	grch.
Anthropopathísmus	grch.
Anthropophobie	grch.
Anti...	grch.
Antibacchius	grch.
Antichambre	frz.
Antichrese	grch.
Antichrist	grch.
Anti-Corn-Law-League	engl.
Antidoron	grch.
Antidotum	grch.
Antik	lat.
Antikaglien	ital.
Antikritik	grch.
Antilegomena	grch.
Antinomie	grch.
Antinomismus	grch.
Antipathie	grch.
Antiperistáltisch	grch.
Antipharmakon	grch.
Antiphlogistisch	grch.
Antiphon	grch.
Antipoden	grch.
Antipyretika	grch.
Antiqua	lat.
Antiquar	lat.
Antiquieren	lat.
Antiquitäten	lat.
Antispást	grch.
Antístes	lat.
Antistrophe	grch.
Antithese	grch.
Antitoxikon	grch.
Antizipation	lat.
Antöci	grch.
Antonomasie	grch.
Antrophor	grch.
Anurie	grch.
Anus	lat.
Anzeps	lat.
Äon	grch.
Aoríst	grch.
Aórta	grch.
Apage	grch.
Apagoge	grch.
Apanage	frz.
Apárt	frz.
Apathie	grch.
Apepsie	grch.
Aperçu	frz.
Apertur	lat.
Apex	lat.
Aphakie	grch.
Aphäresis	grch.
Aphasie	grch.
Aphelium	grch.
Aphonie	grch.
Aphorísmen	grch.
Aphrodisiaka	grch.
Aphthen	grch.
Apiarium	lat.
Apirie	grch.
Apis	lat.
Aplanat	grch.
Aplomb	frz.
Apnoë	grch.
Apochromat	grch.
Apodíktisch	grch.
Apogamie	grch.
Apogäum	grch.
Apoklaýpse	grch.
Apokalýptik	grch.
Apokalyptiker	grch.
Apokalýptisch	grch.
Apokatastase	grch.
Apokópe	grch.
Apollyon	grch.
Apolog	grch.
Apologetik	grch.
Apologie	grch.
Aponeurose	grch.
Apophthégma	grch.
Apophyse	grch.
Apoplexie	grch.
Apostasie	grch.
Apostata	grch.
Apostel	grch.
Apostolisch	grch.
Apostroph	grch.
Apóstrophe	grch.
Apotheke	grch.
Apotheose	grch.
Apothezien	grch.
Apparat	lat.
Apparition	lat.
Appartement	frz.
Appassionato	ital.
Appéll	frz.
Appellabel	lat.
Appellation	lat.
Appellativum	lat.
Appellieren	lat.
Appéndix	lat.
Apperzeption	lat.
Appetit	lat.
Applanieren	frz.
Applaudieren	lat.
Applikatur	lat.
Applizieren	lat.
Appoggiato	ital.
Appoint	frz.
Apponieren	lat.
Appórt	frz.
Apports	frz.
Apposition	lat.
Apprehendieren	lat.
Appretiation	lat.
Appretieren	frz.
Approbation	lat.
Approchen	frz.
Appropriation	lat.
Approvisionieren	frz.
Approximation	lat.
Appunto	ital.
April	lat.
Apropos	frz.
Apsiden	grch.
Aptieren	lat.
Aqua	lat.
Aquädúkt	lat.
Aquamanile	mittellat.
Aquarium	lat.
Äquator	lat.
à quatre	frz.
Aquavit	lat.
Äquidistánt	lat.
Aquila	lat.
Äquilibrismus	lat.
Äquilibríst	lat.
Äquinoktium	lat.
Äquität	lat.
Äquivalént	lat.
Äquivok	lat.
Ära	lat.
Arachnitis	grch.
Aräometer	grch.
Aräopyknometer	grch.
Arazzi	ital.
Arbit	hebr.
Arbitrage	frz.
Arbiträr	lat.
Arbitrium	lat.
Arbor	lat.
Arcato	ital.
Archaisch	grch.
Archaïsmus	grch.
Archäolog	grch.
Archäologie	grch.
Archegonien	grch.
Archers	frz.
Archetyp	grch.
Archicembalo	ital.
Archidiakonus	grch.
Archiëpiskopat	grch.
Archiereus	grch.
Archimandrit	grch.
Archipresbyter	grch.
Architékt	grch.
Architektonik	grch.
Architektur	grch.
Archivolte	ital.
Arcierengarde	ital.
Arco	ital.
Arcus	lat
Areal	lat.
Arena	lat.
Areola	lat.
Aere perennius	lat.
Argentoratum	lat.
Argentum	lat.
Argot	frz.
Arguieren	lat.
Argus	mytholog.
Argutien	lat.
Argyriden	grch.
Aria cattiva	ital.
Arid	lat.
Arie	ital.
Aries	lat.
Ariette	ital.
Arillus	lat.
Arioso	ital.
Aristokratie	grch.
Arithmetik	grch.
Arkade	frz.
Arkebuse	frz.
Arkosolium	lat.
Arktisch	grch.
Arlecchino	ital.
Armada	span.
Armatur	lat.
Armieren	lat.
Armorial	neulat.
Armüre	frz.
Aroma	grch.
Arpa	ital.
Arpeggio	ital.
Arrangement	frz.
Arrangìeren	frz.
Arrést	mittellat.
Arrêt	frz.
Arretieren	frz.
Arrha	lat.
Arrièregarde	frz.
Arrimage	frz.
Arrivieren	frz.
Arrodieren	lat.
Arrogánt	lat.
Arrogieren	lat.
Arrondierung	frz.
Arrondissement	frz.
Arrosement	frz.
Arrowroot	engl.
Ars	lat.
Arsenal	frz.
Arsis	grch.
Artefákt	lat.
Arterien	grch.
Arteriosklerose	grch.
Arthralgie	grch.
Artifiziéll	frz.
Artikulation	lat.
Artikulieren	lat.
Artillerie	frz.
Artíst	frz.
Aerugo	lat.
Asbést	grch.
Asia minor	lat.
Asiento	span.
à son aise	frz.
Aspekten	lat.
Aspergill	lat.
Aspermatismus	grch.
Aspersion	lat.
Asphyxie	grch.
Aspik	frz.
Aspiránt	lat.
Aspiration	lat.
Aspirator	lat.
Aspirieren	lat.
Assai	ital.
Assassin	frz.
Assemblée	frz.
Assentieren	lat.
Assertion	lat.
Asservation	lat.
Asséssor	lat.
Assibilation	lat.
Assiette	frz.
Assignaten	frz.
Assignation	lat.
Assimilation	lat.
Assisen	frz.
Assistént	lat.
Associé	frz.
Assonánz	lat.
Assortiment	frz.
Assoziation	neulat.
Assumieren	lat.
Assurance	frz.
Astasie-Abasie	grch.
Astatisch	grch.
Asterisch	grch.
Asterískos	grch.
Asthenie	grch.
Asthenopie	grch.
Ästhesiometer	grch.
Ästhesioneurosen	grch.
Ästhetik	grch.
Ästhetisch	grch.
Asthma	grch.
Astigmatismus	grch.
Ästimation	lat.
Astragalus	grch.
Astrognosie	grch.
Astrographie	grch.
Astrolabium	grch.
Astrolatrie	grch.
Astrologie	grch.
Astrometrie	grch.
Astronomie	grch.
Astrophotographie	grch.
Astrophotometrie	grch.
Astrophysik	grch.
Ästuarium	lat.
Asyl	grch.
Asymmetrie	grch.
Asymptote	grch.
Asyndeton	grch.
Aszendénten	lat.
Aszese	grch.
Ataktisch	grch.
Atamán	russ.
Atavismus	lat.
Ataxie	grch.
Atelektase	grch.
Atelie	grch.
Atelier	frz.
Äternat	neulat.
Äternität	lat.
Athanasie	grch.
Atheïsmus	grch.
Äther	grch.
Atherman	grch.
Atherom	grch.
Athetose	grch.
Aethiops	lat.
Athlet	grch.
At home	engl.
Atimie	grch.
Ätiologie	grch.
Atmeidan	türk.
Atmiatrie	grch.
Atmometer	grch.
Atmosphäre	grch.
Atmosphärologie	grch.
Atome	grch.
Atomístik	grch.
Atonie	grch.
Atout	frz.
Atra bilis	lat.
Atresie	grch.
Atria mortis	lat.
Atrium	lat.
Atrophie	grch.
Atropos	grch.
Atrozität	lat.
Attacca	ital.
Attaché	frz.
Attacke	frz.
Attemperieren	lat.
Attemporieren	lat.
Attént	lat.
Attentat	lat.
Attention	frz.
Attenuieren	lat.
Attitüde	frz.
Attorney	engl.
Attraktion	lat.
Attrappe	frz.
Attribuieren	lat.
Attrition	lat.
Atypisch	grch.
Aubade	frz.
Aubergine	frz.
Audiénz	lat.
Auditeur	frz.
Auditor	lat.
Auditorium	lat.
Augmént	lat.
Augmentation	lat.
Augmentativum	lat.
Augmentieren	lat.
Augustus	lat.
Auktion	lat.
Auktor	lat.
Aula	lat.
Aulet	grch.
Aura	lat.
Aureole	lat.
Auriga	lat.
Aurikular	lat.
Auri sacra fames	lat.
Aurum	lat.
Auskultation	lat.
Auskultator	lat.
Auskultieren	lat.
Auspex	lat.
Auspizien	lat.
Austral	lat.
Autobiographie	grch.
Autochrom	grch.
Autochthon	grch.
Auto de Fé	span.
Autodidákt	grch.
Autodynamisch	grch.
Autogonie	grch.
Autographen	grch.
Autographie	grch.
Autohypnose	grch.
Autokephal	grch.
Autokratie	grch.
Autokritik	grch.
Automat	grch.
Autonomie	grch.
Autoplástik	grch.
Autopsie	grch.
Autor	lat.
Autorisation	lat.
Autos de Fé	span.
Autoskopie	grch.
Autotypen	grch.
Autotypie	grch.
Autotypographie	grch.
Autözisch	grch.
Autumnal	lat.
Auxiliar	lat.
Auxometer	grch.
Aval	frz.
Avance	frz.
Advancement	frz.
Avantage	frz.
Avant-corps	frz.
Avantgarde	frz.
Avantmain	frz.
Avanzo	ital.
Avarie	frz.
Ave Maria	lat.
Aventure	frz.
Avenue	frz.
Avérs	lat.
Aversion	lat.
Avérsum	lat.
Avertieren	frz.
Avertissement	frz.
Aviarium	lat.
Avidität	lat.
Avis	frz.
Avivieren	frz.
Avoir	frz.
Avoué	frz.
Avouieren	frz.
Avulsion	lat.
Axillar	lat.
Axiom	grch.
Axiometer	grch.
Axonometrie	grch.
Azidität	lat.
Azimut	arab.
Azoospermie	grch.
Azulejos	span.
Azuré	frz.
Azygie	grch.
Azymiten	grch.
Baal	hebr.
Bab	arab.
Baba	slaw.
Bâbâ	türk.
Babusche	türk.
Baby	engl.
Bacca	lat.
Bacile	ital.
Backschisch	pers.
Backwoods	engl.
Baculus	lat.
Bagage	frz.
Bagasse	frz.
Bagatelle	frz.
Bagno	ital.
Bagno	ital.
Bagpipe	engl.
Baguette	frz.
Bahr	arab.
Baidak	russ.
Baigneuse	frz.
Bailiff	engl.
Bain-marie	frz.
Bains	frz.
Bairaktár	türk.
Baisemain	frz.
Baiser	frz.
Baisse	frz.
Bajazzo	ital.
Bajoire	frz.
Bakteriologie	grch.
Bakterioskopie	grch.
Bakterizid	neulat.
Balafre	frz.
Balagán	russ.
Balance	frz.
Balanitis	grch.
Baldowern	hebr.
Baléster	mittellat.
Ballerina	ital.
Ballétt	ital.
Balliste	lat.
Ballístik	grch.
Ballon	frz.
Ballonet	frz.
Ballot	frz.
Ballotade	frz.
Ballotage	frz.
Balordo	ital.
Balteus	lat.
Balustrade	frz.
Bambino	ital.
Bamboo	engl.
Banause	grch.
Bandage	frz.
Banderilla	span.
Banderole	frz.
Bandit	ital.
Bandola	span.
Bank-holidays	engl.
Banlieue	frz.
Banquette	frz.
Banzai	japan.
Baptisten	grch.
Baptisterium	grch.
Bar	engl.
Barat	türk.
Barataria	mittellat.
Baratterie	ital.
Barbakane	frz.
Barbar	grch.
Barbarisch	grch.
Barbarossa	ital.
Barbatus	lat.
Barbe	frz.
Barbette	frz.
Bardale	kelt.
Barile	ital.
Bariolage	frz.
Barkarole	ital.
Barkone	ital.
Barograph	grch.
Barometer	grch.
Barometrograph	grch.
Barrage	frz.
Barranco	span.
Barrel	engl.
Barrière	frz.
Barrikaden	frz.
Barrister	engl.
Bartholomäus	hebr.
Barûch	hebr.
Bary...	grch.
Barysphäre	grch.
Barytonon	grch.
Basane	frz.
Basar	pers.
Bas-Breton	frz.
Basch	türk.
Basch-Kadun	türk.
Baschlik	tatar.
Baschtarde	türk.
Base	grch.
Base Ball	engl.
Basement	frz.
Basileus	grch.
Basilika	grch.
Basis	grch.
Basket	engl.
Basküle	frz.
Basquine	frz.
Basse	holländ.
Basse-taille	frz.
Bassin	frz.
Bassinat	frz.
Bassinet	frz.
Basso continuo	ital.
Basta!	ital.
Basterne	frz.
Bastide	frz.
Bastille	frz.
Bastion	frz.
Bataille	frz.
Bataillon	frz.
Batardeau	frz.
Batholith	grch.
Bathometer	grch.
Bathymeter	grch.
Bâton	frz.
Bâtonnier	frz.
Batrachomyomachia	grch.
Batterie	frz.
Batteur	frz.
Batture	frz.
Battuta	ital.
Bavella	ital.
Bavoche	frz.
Bavolet	frz.
Bazillen	lat.
Bdellometer	grch.
Beagle	engl.
Beata	lat.
Beatifikation	lat.
Beau	frz.
Beau monde	frz.
Beau sexe	frz.
Beauté	frz.
Beaux arts	frz.
Bébé	frz.
Bedeckung	astron.
Beef	engl.
Beef-tea	engl.
Beffroi	frz.
Begum	ind.
Beige	frz.
Bel-esprit	frz.
Belial	hebr.
Bellum	lat.
Belvedere	ital.
Bema	grch.
Ben	hebr.
Bénarde	frz.
Bene	lat.
Benediktion	lat.
Benedizieren	lat.
Benefiz	lat.
Benefizénz	lat.
Benefizial	lat.
Benefiziánt	lat.
Bene meritus	lat.
Bene valete	lat.
Benevolént	lat.
Benignität	lat.
Benjamin	hebr.
Benvenuto	ital.
Berceuse	frz.
Berlingot	frz.
Besdin	hebr.
Béseda	tschech.
Besestan	pers.
Bespopowzy	russ.
Bestialisch	lat.
Bestiarium	lat.
Bète	frz.
Bethanien	hebr.
Bethel	hebr.
Bethlehem	hebr.
Bethphage	hebr.
Bethsaida	hebr.
Bêtise	frz.
Beton	frz.
Betting	engl.
Betula	lat.
Beurten	holländ.
Bezetten	frz.
Bezoar	pers.
Biaisement	frz.
Bianco	ital.
Bibalien	lat.
Biberon	frz.
Bibi	frz.
Biblia pauperum	lat.
Bibliolatrie	grch.
Bibliolithen	grch.
Bibliomantie	grch.
Bibliothek	grch.
Bibliothekographie	grch.
Biceps	lat.
Biche	frz.
Bicho	span.
Bichon	frz.
Bicycle	engl.
Bidet	frz.
Bien	frz.
Biënnal	lat.
Bienséance	frz.
Bienveillance	frz.
Bienvenu	frz.
Bifilar	lat.
Bifluénz	lat.
Biform	lat.
Bifurkation	lat.
Biga	lat.
Biglietto	ital.
Bijou	frz.
Bikonkav	lat.
Bilateral	lat.
Bilboquet	frz.
Bildungsgewebe	botan.
Bileam	hebr.
Bilhas	portug.
Biliar	lat.
Bilínguisch	lat.
Bilis	lat.
Bill	engl.
Billardieren	frz.
Billon	frz.
Bimana	lat.
Bin	türk.
Binokular	lat.
Bioarithmetik	grch.
Biochemie	grch.
Biodynamik	grch.
Biogen	grch.
Biogeographie	grch.
Biographie	grch.
Biologie	grch.
Biomagnetismus	grch.
Biometrie	grch.
Bionomie	grch.
Biophänomenologie	grch.
Bioskopie	grch.
Biosophie	grch.
Biostatik	grch.
Biotomie	grch.
Bipartieren	lat.
Bipeden	lat.
Biquadrat	lat.
Biquet	frz.
Bireme	lat.
Birket	arab.
Bis	lat.
Bise	frz.
Bisektion	lat.
Bisexuéll	lat.
Biskuit	frz.
Bismillâh	arab.
Bisogno	ital.
Bistouri	frz.
Bit	engl.
Bitumen	lat.
Bivalént	neulat.
Bivalven	neulat.
Bizárr	frz.
Blackband	engl.
Black letter	engl.
Bladder	engl.
Blafard	frz.
Blague	frz.
Blamabel	frz.
Blanc	frz.
Blanchet	frz.
Blanchieren	frz.
Blanc-manger	frz.
Blanquillo	span.
Blasiert	frz.
Blasonieren	frz.
Blasphemie	grch.
Blastem	grch.
Blenna	grch.
Blepharitis	grch.
Blessieren	frz.
Blessur	frz.
Bleu	frz.
Bliny	russ.
Blockieren	frz.
Blondin	frz.
Blue Mountains	engl.
Bluette	frz.
Blunder	engl.
Blyde incomste	fläm.
Board	engl.
Bobine	frz.
Bobinoir	frz.
Bocche	ital.
Boccia	ital.
Bodega	span.
Boers	holländ.
Buf	frz.
Bohême	frz.
Boisage	frz.
Bois durci	frz.
Boiserie	frz.
Boitout	frz.
Bola	span.
Bolide	grch.
Bolletten	ital.
Bollitori	ital.
Bolometer	grch.
Bölük	türk.
Bolus	lat.
Bomätsche	slaw.
Bombarda	ital.
Bombarde	frz.
Bombardier	frz.
Bombardon	frz.
Bombasin	frz.
Bombast	engl.
Bombonne	frz.
Bombykometer	grch.
Bon	frz.
Bona	lat.
Bona fides	lat.
Bonanza	span.
Bonbonnière	frz.
Bond	engl.
Bonebed	engl.
Bon gré, mal gré	frz.
Bonheur	frz.
Bonhomme	frz.
Bonifikation	lat.
Boni homines	lat.
Bonis avibus	lat.
Bonis zedieren	lat.
Bonität	lat.
Bon marché	frz.
Bonmot	frz.
Bonne	frz.
Bonnet	frz.
Bonneterie	frz.
Bonorum cessio	lat.
Bon sens	frz.
Bons hommes	frz.
Bon ton	frz.
Bontwerk	holländ.
Bonus	lat.
Bonvivant	frz.
Book-maker	engl.
Boom	engl.
Bootes	grch.
Bora	ital.
Borda	arab.
Bordereau	frz.
Bordüre	frz.
Bore	engl.
Boreal	lat.
Boreas	grch.
Borgo	ital.
Borniert	frz.
Borough	engl.
Borussia	neulat.
Bos	lat.
Bosquet	frz.
Bossage	frz.
Boss-puzzle	engl.
Botanik	grch.
Botrys	grch.
Bottega	ital.
Bottelier	holländ.
Bottola	ital.
Boucherie	frz.
Bouchon	frz.
Boudoir	frz.
Bouffon	frz.
Bougie	frz.
Bougre	frz.
Bouille	frz.
Bouillon	frz.
Boule	frz.
Boulevard	frz.
Bouleversement	frz.
Boulingrin	frz.
Bounty	engl.
Bouquin	frz.
Bourgeois	frz.
Bourrette	frz.
Bourse	frz.
Boutade	frz.
Bouteille	frz.
Bouterolle	frz.
Bouteselle	frz.
Boutique	frz.
Bouton	frz.
Boutonnière	frz.
Bouts-rimés	frz.
Bouzonville	frz.
Bowlinggreen	engl.
Box	engl.
Brä	norweg.
Brabançonne	frz.
Brabeuten	grch.
Bracelet	frz.
Brachial	lat.
Brachy...	grch.
Brachybiotisch	grch.
Brachydaktylisch	grch.
Brachygraphie	grch.
Brachykataléktisch	grch.
Brachykephalie	grch.
Brachylogie	grch.
Brachypetalisch	grch.
Brachypodisch	grch.
Brachysyllabus	grch.
Brachyteleskop	grch.
Bradsot	dän.
Bradykardie	grch.
Braise	frz.
Branche	frz.
Branchien	grch.
Brandy	engl.
Brasserie	frz.
Bravade	frz.
Bravi	ital.
Bravieren	frz.
Bravissimo	ital.
Bravo	ital.
Bravour	frz.
Break	engl.
Breaker	engl.
Breccie	ital.
Bredouille	frz.
Breloques	frz.
Brevet	engl.
Breviarium	lat.
Breviloquénz	lat.
Brevi manu	lat.
Brevis	lat.
Bric-à-brac	frz.
Brigade	frz.
Brigands	frz.
Briganti	ital.
Brigue	frz.
Brikole	frz.
Brillant	frz.
Brillieren	frz.
Brillonetten	frz.
Briolets	frz.
Brioso	ital.
Briquetage	frz.
Briquettes	frz.
Brisánt	frz.
Broad Church	engl.
Broche	frz.
Broderie	frz.
Broker	engl.
Bromios	grch.
Bronchial	grch.
Bronchien	grch.
Bronchitis	grch.
Bronchocele	grch.
Bronteion	grch.
Brontologie	grch.
Broom	engl.
Broschieren	frz.
Brossage	frz.
Brouette	frz.
Brougham	engl.
Brouillement	frz.
Brouillon	frz.
Broyon	frz.
Bruieren	frz.
Brumal	lat.
Brünétt	frz.
Brünieren	frz.
Brüsk	frz.
Brutal	lat.
Bryologie	grch.
Bubo	grch.
Bubonocele	grch.
Buckskin	engl.
Budget	engl.
Buffa	ital.
Buffalo	engl.
Buggy	engl.
Buglehorn	frz.
Bukardie	grch.
Bukolisch	grch.
Bukranion	grch.
Bulbiceps	lat.
Bulbus	lat.
Bule	grch.
Bulette	frz.
Bulk	engl.
Bulla	lat.
Bulletin	frz.
Bulle-tree	engl.
Bullfinch	engl.
Bullion	engl.
Bullition	neulat.
Buluk	türk.
Buninto	japan.
Buphthalmie	grch.
Burattino	ital.
Burda	arab.
Bureau	frz.
Bürette	frz.
Burlésk	ital.
Bursitis	grch.
Busc	frz.
Bushrangers	engl.
Bustrophedón	grch.
Butler	engl.
Buvette	frz.
Bylaws	engl.
Bythometrie	grch.
Cab	engl.
Cabállus	lat.
Cabaret	frz.
Cabildo	span.
Cabinet	frz.
Cable	engl.
Cabo	span.
Cabochon	frz.
Caçadores	portug.
Cacciatori	ital.
Cachalot	frz.
Cachenez	frz.
Cachou	frz.
Cachucha	span.
Cadaver	lat.
Cadeau	frz.
Cadenette	frz.
Cadet	frz.
Cadmia	lat.
Cadran	frz.
Caduceus	lat.
Café	frz.
Cafuso	span.
Cahier	frz.
Caisse	frz.
Caisson	frz.
Cake walk	engl.
Calamus	lat.
Calando	ital.
Calascione	ital.
Calcaria	lat.
Calceus	lat.
Calcio	ital.
Calculus	lat.
Caldarium	lat.
Caldera	span.
Calefáctor	lat.
Calembour(g)	frz.
Calendarium	lat.
Caliche	span.
Calicot	frz.
Caligae	lat.
Calix	lat.
Callus	lat.
Calo	ital.
Calque	frz.
Calumet	frz.
Calyx	lat.
Camarero	span.
Camáuro	ital.
Cambio	ital.
Cambresines	frz.
Cambric	engl.
Cambujo	span.
Cameo	ital.
Camera	lat.
Cameralia	lat.
Camera lucida	lat.
Camera obscura	lat.
Camerarius	lat.
Camerlengo	ital.
Campement	frz.
Campos	portug.
Campo santo	ital.
Camp volant	frz.
Canaille	frz.
Cancan	frz.
Cancellaria	lat.
Cancer	lat.
Cancionero	span.
Cancrinus versus	lat.
Candidatus	lat.
Canepin	frz.
Canicula	lat.
Cannelas	frz.
Cañon	span.
Canot	frz.
Cant	engl.
Cantabile	ital.
Cantando	ital.
Cantatorium	lat.
Canticum	lat.
Cantileverbrücke	engl.
Canto	ital.
Cantus	lat.
Cape	engl.
Capella	lat.
Capillitium	lat.
Capitaine	frz.
Capitano	ital.
Capitato	ital.
Capite censi	lat.
Capitis deminutio	lat.
Capo	ital.
Capot	frz.
Capotasto	ital.
Cappa	mittellat.
Capra	lat.
Capreolus	lat.
Capriccio	ital.
Capricornus	lat.
Captatio benevolentiae	lat.
Capuchon	frz.
Caput	lat.
Caput Medusae	lat.
Caput mortuum	lat.
Caque	frz.
Carabiniers	frz.
Carafon	frz.
Carbo	lat.
Carcer	lat.
Cardia	grch.
Cardiaca	grch.
Cardinalia	lat.
Carême	frz.
Carica	ital.
Caries	lat.
Carillon	frz.
Carità	ital.
Carmen	lat.
Carminativa	lat.
Carne pura	ital.
Carnivora	lat.
Caro	lat.
Carocha	portug.
Carole	frz.
Carolus Magnus	lat.
Carpe diem	lat.
Carreau	frz.
Carrousel	frz.
Carta	ital.
Carte	frz.
Cartilago	lat.
Cartouche	frz.
Casa	lat.
Casco	ital.
Cassa	ital.
Cassis	frz.
Castle	engl.
Castrum	lat.
Casu	lat.
Casula	lat.
Casus	lat.
Cataracta	grch.
Catboat	engl.
Catchup	engl.
Catgut	engl.
Cathartica	grch.
Cathedra	lat.
Cauda	lat.
Causa	lat.
Causativa	lat.
Cause célèbre	frz.
Causerie	frz.
Causeway	engl.
Caustica	lat.
Cavaliere	ital.
Cavalierement	frz.
Cavaliere servente	ital.
Cavalleggieri	ital.
Cavalleria	ital.
Caveat	lat.
Cédille	frz.
Cedo majori	lat.
Cédule	frz.
Ceinture	frz.
Célèbre	frz.
Celere	ital.
Cella	lat.
Cembalo	ital.
Cendal	frz.
Cendrillon	frz.
Cenoman	geolog.
Centgardes	frz.
Cent-jours	frz.
Cento	lat.
Centum	lat.
Centweight	engl.
Cera	lat.
Cercle	frz.
Cerebellum	lat.
Cereoli	lat.
Cerise	frz.
Cerro	span.
Certamen	lat.
Certepartie	frz.
Cerumen	neulat.
Cerussa	lat.
Cervix	lat.
Cervus	lat.
Ceteris paribus	lat.
Chabins	frz.
Chabotte	frz.
Chacham	hebr.
Chaconne	frz.
Chagrin	frz.
Chagrin	frz.
Chain	engl.
Chaine	frz.
Chaise	frz.
Chaiselongue	frz.
Chalaza	grch.
Chalet	frz.
Chalikosis	grch.
Chalkelephantin	grch.
Chalkograph	grch.
Chalkotypie	grch.
Chaly	frz.
Chalybs	grch.
Chamaeleon minerale	lat.
Chambellan	frz.
Chambre	frz.
Chamois	frz.
Champ	frz.
Champignon	frz.
Champion	frz.
Champlevé	frz.
Chance	frz.
Chancelier	frz.
Chancellor	engl.
Chancre	frz.
Change	frz.
Changeant	frz.
Changement	frz.
Chanson	frz.
Chansonette	frz.
Chantage	frz.
Chaos	grch.
Chapeau	frz.
Chapel	engl.
Chapelle	frz.
Chaperon	frz.
Chapetones	span.
Chapitre	frz.
Chappe	frz.
Char	frz.
Character indelebilis	lat.
Charakter	grch.
Charbonnerie	frz.
Charcuterie	frz.
Charge	frz.
Chargé	frz.
Chargé d'Affaires	frz.
Charis	grch.
Charitas	lat.
Charité	frz.
Charivari	frz.
Charlemagne	frz.
Charlière	frz.
Charon	grch.
Charque	span.
Chartepartie	frz.
Chartered Company	engl.
Chartern	engl.
Chartularia	neulat.
Chasan	hebr.
Chasmus	grch.
Chassé	frz.
Chasseur	frz.
Châssis	frz.
Château	frz.
Châteaux en Espagne	frz.
Châtelaine	frz.
Chatîb	arab.
Châton	frz.
Chaudeau	frz.
Chauffeur	frz.
Chaussée	frz.
Chaussure	frz.
Checks	engl.
Cheer	engl.
Chef	frz.
Chef d'uvre	frz.
Cheilitis	grch.
Cheirospasmus	grch.
Cheirotonie	grch.
Chemigraphie	grch.
Chemin	frz.
Chemise	frz.
Chemitypie	grch.
Chemosis	grch.
Chemotaxis	grch.
Chenille	frz.
Chèque	frz.
Chère	frz.
Cherub	hebr.
Chevalerésk	frz.
Chevalier	frz.
Chevaulegers	frz.
Cheviot	engl.
Chevreau	frz.
Chevron	frz.
Chiaroscuro	ital.
Chiasma	grch.
Chiasmus	grch.
Chicane	frz.
Chicha	span.
Chiffon	frz.
Chiffre	frz.
Chignon	frz.
Chiliásmus	grch.
Chiné	frz.
Chinois	frz.
Chipolin	frz.
Chiragra	grch.
Chirogrammatomantie	grch.
Chirograph	grch.
Chiromantie	grch.
Chiroplást	grch.
Chirotheken	grch.
Chirúrg	grch.
Chirurgie	grch.
Chiton	grch.
Chiusa	ital.
Chlaina	grch.
Chlamys	grch.
Chliaren	grch.
Chliasma	grch.
Chloasma	grch.
Chloë	grch.
Choanen	grch.
Chokieren	frz.
Cholagoga	grch.
Choleriker	grch.
Cholesteatom	grch.
Choliambus	grch.
Cholo	span.
Cholosen	grch.
Chômage	frz.
Chondrin	grch.
Chor	grch.
Chorda	lat.
Chorditis	grch.
Chordometer	grch.
Chorea	grch.
Choreographie	grch.
Choreomanie	grch.
Choreus	grch.
Choreutik	grch.
Choriambus	grch.
Chorioïdea	grch.
Chorion	grch.
Chorographie	grch.
Chose	frz.
Chrematístik	grch.
Chrematologie	grch.
Chresmolog	grch.
Chrestomathie	grch.
Chrië	grch.
Chrisma	grch.
Christianissimus	lat.
Christmas	engl.
Christolatrie	grch.
Christologie	grch.
Christophanie	grch.
Christophórus	grch.
Christus	grch.
Chroma	grch.
Chromatik	grch.
Chromatisch	grch.
Chromatologie	grch.
Chromatophoren	grch.
Chromatopsie	grch.
Chromatosen	grch.
Chromatoskop	grch.
Chromatrop	grch.
Chromogene	grch.
Chromolith	grch.
Chromolithographie	grch.
Chromophor	grch.
Chromophotographie	grch.
Chromophototherapie	grch.
Chromoplásten	grch.
Chromopsie	grch.
Chromoskop	grch.
Chromosphäre	grch.
Chromotherapie	grch.
Chromoxylographie	grch.
Chronik	grch.
Chronique scandaleuse	frz.
Chronisch	grch.
Chronódeik	grch.
Chronógramm	grch.
Chronograph	grch.
Chronoïsothérmen	grch.
Chronologie	grch.
Chronologisch	grch.
Chronometer	grch.
Chronometrie	grch.
Chronophotographie	grch.
Chronostichon	grch.
Chroologie	grch.
Chrupsie	grch.
Chrysaliden	grch.
Chryselephantin	grch.
Chrysographie	grch.
Chrysomorphisch	grch.
Chrysostómus	grch.
Chthonisothérmen	grch.
Chútor	russ.
Chyl'at	arab.
Chylurie	grch.
Chylus	grch.
Chymus	grch.
Ciaccona	ital.
Cicerone	ital.
Cicisbeo	ital.
Ciconia	lat.
Cidade	portug.
Ci-devant	frz.
Cima	ital.
Cimarrones	span.
Ciment	frz.
Cinders	engl.
Cinquecento	ital.
Cippus	lat.
Circa	lat.
Circassienne	frz.
Circulaire	frz.
Circulus	lat.
Cirrhose	grch.
Cirrhus	lat.
Cirrifórm	lat.
Cirrokumulus	lat.
Cirrostratus	lat.
Cirsocele	grch.
Cirsomphalus	grch.
Cissoide	grch.
Cista	lat.
Citato loco	lat.
Cité	frz.
Citissime	lat.
Cito	lat.
Citoyen	frz.
Città	ital.
City	engl.
Ciudad	span.
Civette	frz.
Civis	lat.
Cività	ital.
Civitas	lat.
Claim	engl.
Clairet	frz.
Clair-obscur	frz.
Clairvoyance	frz.
Clan	kelt.
Claque	frz.
Claque	frz.
Clarette	frz.
Clasp	engl.
Clausula	lat.
Clausura	lat.
Clavecin	frz.
Clavicula	lat.
Clavis	lat.
Clearinghouse	engl.
Clementia	lat.
Clerc	frz.
Clericus	lat.
Clerk	engl.
Clipeus	lat.
Clippers	engl.
Clique	frz.
Cloisonné	frz.
Clou	frz.
Clown	engl.
Coach	engl.
Coagulum	lat.
Coaks	engl.
Coaetaneus	lat.
Coating	engl.
Cochenille	frz.
Cochon	frz.
Cocktail	engl.
Coecum	lat.
Cod	engl.
Coda	ital.
Code	frz.
Codex	lat.
Cod-liver oil	engl.
Cod-oil	engl.
Coeur	frz.
Cofferdam	engl.
Cognomen	lat.
Coherer	engl.
Coheres	lat.
Coiffeur	frz.
Coitus	lat.
Cökal	lat.
Col	frz.
Cola	ital.
Cold-cream	engl.
Cölialgie	grch.
Coliseo	ital.
Colla parte	ital.
Coll' arco	ital.
Colle	ital.
Collé	frz.
Collectanea	lat.
Collegialiter	lat.
Collegia pietatis	lat.
Collet	frz.
Collum	lat.
Colonel	frz.
Colonia	lat.
Colonus	lat.
Columna	lat.
Combes	frz.
Come	ital.
Comédie	frz.
Comedo	lat.
Comes	lat.
Cömeterium	grch.
Comitatus	lat.
Comites	lat.
Commedia	ital.
Comme il faut	frz.
Commemoratio	lat.
Comménda	mittellat.
Commentarii	lat.
Commercium	lat.
Commilito	lat.
Commodatum	lat.
Commodum	lat.
Commoners	engl.
Commonitorium	lat.
Common Law	engl.
Commons	engl.
Common sense	engl.
Commune	frz.
Communi	ital.
Communio	lat.
Communiqué	frz.
Comoedia	lat.
Comparatio	lat.
Compartimento	ital.
Compère	frz.
Complaisance	frz.
Compositum	lat.
Comptant	frz.
Compte	frz.
Comptoir	frz.
Comte	frz.
Comtesse	frz.
Comuni	ital.
Coena	lat.
Con affetto	ital.
Conatus	lat.
Con brio	ital.
Concedo	lat.
Concepi	lat.
Conceptio	lat.
Concetti	ital.
Concha	lat.
Concierge	frz.
Concilium	lat.
Conclusio	lat.
Concordia	lat.
Concursus	lat.
Condictio	lat.
Conditio	lat.
Con dolore	ital.
Condominium	lat.
Condýlus	grch.
Confessio	lat.
Confessionarius	neulat.
Confessor	lat.
Confiteor	lat.
Confitures	frz.
Confort	frz.
Con forza	ital.
Confrater	lat.
Con fuoco	ital.
Con grandezza	ital.
Conjunctiva	lat.
Cunjuratores	lat.
Con leggerezza	ital.
Con moto	ital.
Connaissance	frz.
Connaissement	frz.
Connubium	lat.
Con passione	ital.
Consacramentales	mittellat.
Consanguinei	lat.
Consecutio	lat.
Conseil	frz.
Consensus	lat.
Consilia evangelica	lat.
Consilium	lat.
Consolidantia	lat.
Consommé	frz.
Con sordino	ital.
Consorteria	ital.
Con spirito	ital.
Constable	engl.
Constituante	frz.
Constitutio	lat.
Constrictor	lat.
Constringentia	lat.
Consummatum est	lat.
Conte	ital.
Contenance	frz.
Content	frz.
Continuatio	lat.
Contorni	ital.
Contour	frz.
Contra	lat.
Contractus	lat.
Contradictio	lat.
Contrarium	lat.
Contra sextum	lat.
Contre	frz.
Contre-coup	frz.
Contumacia	lat.
Conus	lat.
Convivium	lat.
Convocation	engl.
Convoi	frz.
Cooch Behar	engl.
Cooperative stores	engl.
Cop	engl.
Copia	lat.
Copperhead	engl.
Copyholders	engl.
Copyright	engl.
Coquelicot	frz.
Coquillage	frz.
Coquille	frz.
Cor	lat.
Coram	lat.
Corbeille	frz.
Corda	ital.
Cordialiter	lat.
Cordite	engl.
Corge	engl.
Corium	lat.
Cornea	lat.
Corned beef	engl.
Corner	engl.
Cornet	frz.
Corniche	frz.
Corno	ital.
Cornu	lat.
Corolla	lat.
Corona	lat.
Coroner	engl.
Corpora	lat.
Corporale	lat.
Corps	frz.
Corpus	lat.
Corpus Chrísti	lat.
Corpus delicti	lat.
Corpus Domini	lat.
Corpus juris	lat.
Corrénda	ital.
Corrigénda	lat.
Corriger la fortune	frz.
Corrodentia	lat.
Cortex	lat.
Corylus	lat.
Corymbus	lat.
Cosa	ital.
Così fan tutte	ital.
Costa Rica	span.
Costi	ital.
Côté	frz.
Cotillac	frz.
Coton	frz.
Cottage	engl.
Cotton	engl.
Cötus	lat.
Coulage	frz.
Coulant	frz.
Couleur	frz.
Coulisse	frz.
Couloir	frz.
Council	engl.
Councillor	engl.
Counsel	engl.
Count	engl.
Country	engl.
County	engl.
Coup	frz.
Coupage	frz.
Coupe	frz.
Coupé	frz.
Coupieren	frz.
Couplet	frz.
Coupon	frz.
Coupure	frz.
Cour	frz.
Courage	frz.
Courant	frz.
Courbette	frz.
Courge	frz.
Cours	frz.
Court	engl.
Courtage	frz.
Courtoisie	frz.
Coutumes	frz.
Couvade	frz.
Couveuse	frz.
Couvre-face	frz.
Cowboy	engl.
Cowcatcher	engl.
Coxa	lat.
Cracovienne	frz.
Crambe repetita	lat.
Crannoges	kelt.
Craquelée	frz.
Crayon	frz.
Creator	lat.
Credo	lat.
Creek	engl.
Cremaillère	frz.
Crême	frz.
Cremor	lat.
Crêpe	frz.
Crescendo	ital.
Creta	lat.
Crête	frz.
Crève-cur	frz.
Cribbage	engl.
Crimen	lat.
Crin d'Afrique	frz.
Crin végétal	frz.
Croccia	ital.
Croche	frz.
Crochet	frz.
Croisé	frz.
Crop	engl.
Croquettes	frz.
Croquis	frz.
Croup	engl.
Croupade	frz.
Croupier	frz.
Crucis	lat.
Crux	lat.
Cruzada	span.
Cubiculum	lat.
Cuchilla	span.
Cucúllus	lat.
Cucurbita	lat.
Cudbear	engl.
Cui bono	lat.
Cul	frz.
Culot	frz.
Culpa	lat.
Cum grano salis	lat.
Cum infamia	lat.
Cum laude	lat.
Cuneus	lat.
Cuprum	lat.
Cura	lat.
Curé	frz.
Curiosa	lat.
Currency	engl.
Curriculum vitae	lat.
Custodia	lat.
Cuticula	lat.
Cutis	lat.
Cuvelage	frz.
Cyanoblepsie	grch.
Cyanometer	grch.
Cyanose	grch.
Cyanotypie	grch.
Cyma	lat.
Cystitis	grch.
Czako	poln.
Czapka	poln.
Da capo	ital.
D'accord	frz.
Dagg	holländ.
Dagh	türk.
Dahabîje	arab.
Dâk	sanskr.
Dakryoadenitis	grch.
Daktylen	grch.
Daktyliomantie	grch.
Daktyliothek	grch.
Daktylitis	grch.
Daktylologie	grch.
Daktylolyse	grch.
Daktyloskopie	grch.
Daktylosymphysis	grch.
Daktylus	grch.
Dalles	hebr.
Damnabel	lat.
Damnifizieren	lat.
Damnum	lat.
Damoiseau	frz.
Dämonen	grch.
Dandy	engl.
Daniel	hebr.
Danse macabre	frz.
Dàr	arab.
Dasjespiß	holländ.
Dasymeter	grch.
Datieren	lat.
Datscha	russ.
Datum	lat.
Davit	engl.
Days of humiliation	engl.
Dea	lat.
Dean	engl.
Debardieren	frz.
Debarkieren	frz.
Debatte	frz.
Débauche	frz.
Debet	lat.
Debil	lat.
Debit	frz.
Debitor	lat.
Debitum	lat.
Deblockieren	frz.
Debora	hebr.
Debordieren	frz.
Débouché	frz.
Deboursieren	frz.
Décadence	frz.
Decemviri	lat.
Decharge	frz.
Dechiffrieren	frz.
Decidua	lat.
Decima	lat.
Décime	frz.
Declaration of independence	engl.
Declaration of rights	engl.
Décomte	frz.
Decorum	lat.
Decouragement	frz.
Décourt	frz.
Découvert	frz.
Decouvrieren	frz.
Decrescendo	ital.
Decretum	lat.
Decubitus	lat.
De dato	lat.
Dedignation	lat.
Dedication	lat.
Dedit	lat.
Dedition	lat.
Deductio ad absúrdum	lat.
Deduktion	lat.
De facto	lat.
Defäkation	lat.
Defamation	lat.
Defatigation	lat.
Defékt	lat.
Defektivum	lat.
Defendieren	lat.
Defension	lat.
Defensiv	lat.
Defénsor	lat.
Deferént	lat.
Deferénz	lat.
Défiance	frz.
Defiguration	lat.
Défilé	frz.
Défilement	frz.
Definition	lat.
Definitiv	lat.
Definitoren	lat.
Defizit	lat.
Deflation	lat.
Deflektieren	lat.
Defléktor	lat.
Defloration	lat.
Defoliation	lat.
Defórm	lat.
Defterdar	pers.
Degeneration	lat.
Deger	dän.
Degommieren	frz.
Degorgieren	frz.
Degout	frz.
Degradation	lat.
Dégras	frz.
Degustieren	lat.
Deï gratia	lat.
De integro	lat.
Deïtät	lat.
Dejektion	lat.
Dejizieren	lat.
De jure	lat.
Dejurieren	lat.
Deka...	grch.
Dekachórd	grch.
Dekade	grch.
Dekaeder	grch.
Dekagon	grch.
Dekagynisch	grch.
Dekalog	grch.
Dekameron	grch.
Dekándrisch	grch.
Dekantieren	lat.
Dekapieren	frz.
Dekapitation	frz.
Dekapolis	grch.
Dekas	grch.
Dekastichon	grch.
Dekastylon	grch.
Dekatieren	frz.
Deklamation	lat.
Deklaration	lat.
Deklination	lat.
Dekliv	lat.
Dekókt	lat.
Dekolletiert	frz.
Dekoloration	lat.
Dekomponieren	lat.
Dekonzertieren	frz.
Dekor	frz.
Dekorateur	frz.
Dekoration	lat.
Dekreditieren	frz.
Dekrepit	lat.
Dekrepitieren	lat.
Dekreszénz	lat.
Dekretalen	lat.
Dekretieren	frz.
Délaissement	frz.
Delation	lat.
Deleatur	lat.
Delegation	lat.
Delektieren	lat.
Deletär	neulat.
Deliberation	lat.
Deliciae	lat.
Delieren	lat.
Delikat	lat.
Delineation	lat.
Delinquént	lat.
Delirium	lat.
Delkredere	ital.
Délogement	frz.
Déloyal	frz.
Demagog	grch.
Demarkation	frz.
Demaskieren	frz.
Démêlé	frz.
Démembrement	frz.
Demen	grch.
Démenti	frz.
Dementia	lat.
Demersion	lat.
Demi	frz.
Demi-glace	frz.
Demijohn	engl.
Demi-lune	frz.
Demi-monde	frz.
Deminutivum	lat.
Demir-Kapu	türk.
Demission	frz.
Demiúrg	grch.
Demographie	grch.
Demoiselle	frz.
Demokratie	grch.
Demolieren	frz.
Demologie	grch.
Demonetisieren	frz.
Demonstration	lat.
Démontage	frz.
Demontieren	frz.
Demoralisation	frz.
Demotisch	grch.
Demulzieren	lat.
Denaturalisieren	frz.
Denaturieren	frz.
Dendriten	grch.
Dendrolithen	grch.
Dendrologie	grch.
Dendrometer	grch.
Denegation	lat.
Denobilitieren	neulat.
Denomination	lat.
Denominativum	lat.
Dénouement	frz.
De novo	lat.
Densität	lat.
Dent	frz.
Dental	lat.
Dentelieren	frz.
Dentition	lat.
Denudation	lat.
Denunziation	lat.
Deo gratias	lat.
Departement	frz.
Departieren	frz.
Depekoration	neulat.
Dependénz	lat.
Depense	frz.
Deperdieren	lat.
Depilation	lat.
Deplacement	frz.
Deplacieren	frz.
Deplantation	lat.
Deplorabel	lat.
Deployieren	frz.
Depolarisation	lat.
Deponens	lat.
Deponént	lat.
Depórt	frz.
Deportation	lat.
Deposition	lat.
Depossedieren	frz.
Depot	frz.
Depotenzieren	neulat.
Depravation	lat.
Deprehension	lat.
Deprekation	lat.
Deprekatur	mittellat.
Depressieren	frz.
Depression	lat.
Depretiieren	lat.
Deprezieren	lat.
Deprimieren	lat.
Deprivation	lat.
De profundis	lat.
Depurantia	lat.
Deputat	lat.
Deputation	lat.
Derangieren	frz.
Dereliktion	lat.
Derivantia	lat.
Derivate	lat.
Derivation	lat.
Derma	grch.
Dermatologie	grch.
Dermatoplástik	grch.
Dermatozoen	grch.
Dermoplástik	grch.
Derogation	lat.
Deroute	frz.
Derwisch	pers.
Desarmieren	frz.
Desaven	frz.
Descente	frz.
Desért	lat.
Desertion	lat.
Deserviten	lat.
Desiderabel	lat.
Designation	lat.
Desinfektion	frz.
Desistieren	lat.
Deskription	lat.
Desmographie	grch.
Desmopathie	grch.
Desolat	frz.
Desordre	frz.
Desorganisation	frz.
Despektieren	lat.
Desperados	span.
Desperat	lat.
Despot	grch.
Desquamation	lat.
Dessein	frz.
Dessert	frz.
Desservant	frz.
Dessin	frz.
Destillation	lat.
Destinatär	frz.
Destituieren	lat.
Destruieren	lat.
Deszendénten	lat.
Detachement	frz.
Detail	frz.
Détente	frz.
Detention	lat.
Deterioration	lat.
Determinánten	lat.
Determination	lat.
Determinismus	lat.
Deterrition	lat.
Detestieren	lat.
Dethronisieren	neulat.
Detinieren	lat.
Detonation	lat.
Detonator	lat.
Détour	frz.
Detrahieren	lat.
Detrektation	lat.
Detrimént	lat.
Detritus	lat.
Détroit	frz.
Dette	frz.
Detto	ital.
Déus	lat.
Deuterokanonisch	grch.
Deuteronomium	grch.
Deuteropáthisch	grch.
Deuteroskopie	grch.
Devalvation	neulat.
Devantière	frz.
Devastation	lat.
Developpabel	frz.
Devestieren	lat.
Deviation	lat.
Devil	engl.
Devise	mittellat.
Devitrifikation	neulat.
Devolution	lat.
Devolvieren	lat.
Devot	lat.
Dexterität	lat.
Dezedieren	lat.
Dezémvirn	lat.
Dezennium	lat.
Dezént	lat.
Dezentralisation	lat.
Dezeption	lat.
Dezernieren	lat.
Dezession	lat.
Dezidieren	lat.
Dezimal	lat.
Dezime	lat.
Dezimieren	lat.
Dezision	lat.
Diabetes	grch.
Diable	frz.
Diablotins	frz.
Diabolus	grch.
Diadélphisch	grch.
Diadem	grch.
Diadóche	grch.
Diadóchen	grch.
Diadumenos	grch.
Diaglyphisch	grch.
Diagnose	grch.
Diagometer	grch.
Diagonal	grch.
Diagrámm	grch.
Diagraph	grch.
Diagraphie	grch.
Diakonissinnen	grch.
Diakonus	grch.
Diakrise	grch.
Dialékt	grch.
Dialéktik	grch.
Dialektologie	grch.
Dialémma	grch.
Diallele	grch.
Dialog	grch.
Dialyse	grch.
Dialyten	grch.
Diameter	grch.
Diamorum	grch.
Diandrisch	grch.
Dianöologie	grch.
Diantre	frz.
Diapason	grch.
Diapédesis	grch.
Diapénte	grch.
Diaphan	grch.
Diaphanometer	grch.
Diaphanoskop	grch.
Diaphoresis	grch.
Diaphragma	grch.
Diaphyse	grch.
Diaplasma	grch.
Diapnoe	grch.
Diapyem	grch.
Diarchie	grch.
Diarium	lat.
Diarrhöe	grch.
Diarthrose	grch.
Diaskeuást	grch.
Diaspora	grch.
Diastáltisch	grch.
Diastase	grch.
Diastasis	grch.
Diastimeter	grch.
Diastole	grch.
Diastylos	grch.
Diät	grch.
Diatessaron	grch.
Diatherman	grch.
Diathese	grch.
Diatonisch	grch.
Diatreta	grch.
Diatribe	grch.
Diaulos	grch.
Diavolo	ital.
Dibrachys	grch.
Dichasium	grch.
Dichogamie	grch.
Dichotomie	grch.
Dichroïsmus	grch.
Dichromatisch	grch.
Dichroskop	grch.
Dicta	lat.
Dictando	lat.
Dictionnaire	frz.
Dictum	lat.
Didache	grch.
Didáktik	grch.
Didaskalien	grch.
Didymi	grch.
Didynamisch	grch.
Diëgesis	grch.
Diëm perdidi	lat.
Diës	lat.
Dièse	frz.
Dieu et mon Droit	frz.
Diffalco	ital.
Differént	lat.
Differential...	neulat.
Differénz	lat.
Differenzieren	lat.
Differieren	lat.
Diffession	lat.
Diffidénz	lat.
Diffikultät	lat.
Diffizil	lat.
Diffórm	lat.
Diffraktion	lat.
Diffundieren	lat.
Digerieren	lat.
Digésten	lat.
Digestion	lat.
Digéstor	lat.
Digitus	lat.
Diglyph	grch.
Dignánd	lat.
Dignitar	neulat.
Digression	lat.
Digynisch	grch.
Dii	lat.
Dijudikation	lat.
Dikatópter	grch.
Dike	grch.
Dikephalus	grch.
Diklinisch	grch.
Dikolon	grch.
Dikotyledonen	grch.
Diktat	lat.
Diktator	lat.
Diktieren	lat.
Diktion	lat.
Diktyitis	grch.
Dilatabel	neulat.
Dilation	lat.
Dilémma	grch.
Dilettánt	ital.
Diligence	frz.
Diluentia	lat.
Diluvium	lat.
Dimension	lat.
Dimeter	grch.
Dimidium	lat.
Diminuéndo	ital.
Diminuieren	lat.
Dimission	lat.
Dimissoriale	lat.
Dimittieren	lat.
Dimity	engl.
Dimorphismus	grch.
Diner	frz.
Dinieren	frz.
Diópter	grch.
Dióptrik	grch.
Diorama	grch.
Dioskuren	grch.
Diözese	grch.
Diözisch	grch.
Diphthóng	grch.
Diphyodónt	grch.
Diphyzérk	grch.
Diplegie	grch.
Dipleidoskop	grch.
Diploë	grch.
Diplom	grch.
Diplomatie	grch.
Diplomatik	grch.
Diplopie	grch.
Dipodie	grch.
Dipsodisch	grch.
Dipterologie	grch.
Dipteros	grch.
Diptychon	grch.
Dira necessitas	lat.
Dirékt	lat.
Direktion	lat.
Direktive	neulat.
Diréktor	lat.
Direktorium	lat.
Direktrice	frz.
Dirigént	lat.
Dirk	engl.
Dirtbeds	engl.
Disborso	ital.
Discantus	lat.
Discordia	lat.
Discours	frz.
Disért	lat.
Diseur	frz.
Disfiguration	lat.
Disgregation	lat.
Dish	engl.
Disjunktion	lat.
Disjunktoren	lat.
Diskalzeaten	lat.
Diskontinuität	lat.
Diskos	grch.
Diskredit	lat.
Diskrepánz	lat.
Diskret	lat.
Diskretion	lat.
Diskretionär	lat.
Diskúrs	lat.
Diskursiv	lat.
Diskus	grch.
Diskussion	lat.
Dislokation	lat.
Dismembration	lat.
Dispache	frz.
Disparat	lat.
Dispensatorium	lat.
Dispensieren	lat.
Dispersion	lat.
Displantation	neulat.
Disponénda	lat.
Disponént	lat.
Disponibel	lat.
Disponieren	lat.
Disposition	lat.
Disput	lat.
Disputation	lat.
Disqualifikation	lat.
Disséns	lat.
Dissénters	engl.
Dissentieren	lat.
Dissidénten	lat.
Dissidieren	lat.
Dissogonie	grch.
Dissolubel	lat.
Dissolving views	engl.
Dissonánz	lat.
Dissoziation	lat.
Distánz	lat.
Distendieren	lat.
Distichon	grch.
Distinguieren	lat.
Distomatosis	grch.
Distorquieren	lat.
Distrahieren	lat.
Distribuieren	lat.
Distríkt	lat.
Diszession	lat.
Disziplin	lat.
Dithyrámbus	grch.
Diuresis	grch.
Diurnale	lat.
Diva	ital.
Divae memoriae	lat.
Divergieren	lat.
Divérs	lat.
Diversion	lat.
Divertieren	frz.
Divertikel	lat.
Divertiménto	ital.
Divide et impera	lat.
Dividénde	lat.
Dividieren	lat.
Divination	lat.
Divis	lat.
Divisibel	lat.
Division	lat.
Divisor	lat.
Divisorium	neulat.
Divus	lat.
Dîwân	pers.
Dixi	lat.
Dmitrij	russ.
Docéndo discimus	lat.
Dock	engl.
Doctor	lat.
Dodeka	grch.
Dodekaeder	grch.
Dodekagyn	grch.
Dodekándrisch	grch.
Dodekarchie	grch.
Dodrans	lat.
Doeskin	engl.
Dogcart	engl.
Doge	ital.
Dogma	grch.
Dogmatik	grch.
Dokimasie	grch.
Doktrin	lat.
Dokumént	lat.
Dolabra	lat.
Dolce	ital.
Dolce far niénte	ital.
Dolcissimo	ital.
Dolichokephalie	grch.
Dolma	türk.
Dolman	türk.
Dolmen	kelt.
Dolor	lat.
Dolorosa	lat.
Dolos	lat.
Dolus	lat.
Doma	grch.
Domatien	grch.
Domesday Book	engl.
Doméstics	engl.
Domestikation	lat.
Domestike	frz.
Domina	lat.
Dominánte	lat.
Dominica	lat.
Dominicum	lat.
Dominieren	lat.
Dominium	lat.
Domino	ital.
Dominus	lat.
Dominus vobiscum	lat.
Domizil	lat.
Dompelers	holl.
Dompteur	frz.
Donatio	lat.
Donatio Constantini	lat.
Donjon	frz.
Donum	lat.
Doomsday Book	engl.
Dopen	engl.
Dorage	frz.
Doreloterie	frz.
Dormeuse	frz.
Dormitiv	neulat.
Dormitorium	lat.
Dorure	frz.
Doryphoros	grch.
Dos-à-dos	frz.
Dosis	grch.
Dossier	frz.
Dotal	lat.
Dotalitium	lat.
Dotation	lat.
Douane	frz.
Double	frz.
Doublé	frz.
Doublüre	frz.
Doucement	frz.
Douceur	frz.
Douche	frz.
Doucieren	frz.
Dowlas	engl.
Doxale	mittellat.
Doxologie	grch.
Doyen	frz.
Dozént	lat.
Dozieren	lat.
Dragées	frz.
Dragoman	arab.
Dragonne	frz.
Drakontiasis	grch.
Drama	grch.
Dramaturgie	grch.
Dramolett	frz.
Drap	frz.
Draperie	frz.
Drastisch	grch.
Drawback	engl.
Drawing-room	engl.
Drepanon	grch.
Dresseur	frz.
Dressoir	frz.
Drogen	frz.
Droit	frz.
Drôlerie	frz.
Dromones	grch.
Dromos	grch.
Dropazismus	grch.
Drops	engl.
Droschke	russ.
Drosometer	grch.
Drosophor	grch.
Dry	engl.
Dschihâd	arab.
Dschinn	arab.
Dschiu-Dschitsu	japan.
Dschum'a	arab.
Duab	pers.
Dualismus	neulat.
Dubiös	lat.
Dublette	frz.
Dublieren	frz.
Duc	frz.
Ducaton	frz.
Duc d'Albe	frz.
Duché	frz.
Duchesse	frz.
Ductus	lat.
Due	ital.
Duéll	lat.
Due volte	ital.
Duim	niederländ.
Du jour	frz.
Duke	engl.
Duktil	lat.
Dúma	russ.
Dumb-Show	engl.
Duo	lat.
Duodezime	lat.
Düpe	frz.
Düpieren	frz.
Duplikat	lat.
Duplum	lat.
Durabel	lat.
Dura mater	lat.
Durazzo	ital.
Dureszieren	lat.
Dutchman	engl.
Dux	lat.
Dyadik	grch.
Dynameter	grch.
Dynamik	grch.
Dynamis	grch.
Dynamograph	grch.
Dynamologie	grch.
Dynamometamorphismus	grch.
Dynamometer	grch.
Dynást	grch.
Dysämie	grch.
Dyspesie	grch.
Dyspnoe	grch.
Dystrophie	grch.
Eagle	engl.
East	engl.
Eastern Bengal and Assam	engl.
Ebenezer	hebr.
Ebioniten	hebr.
Eblouieren	frz.
Ebullieren	lat.
Ebur	lat.
Ecaille	frz.
Ecarlate	frz.
Ecarté	frz.
Ecce homo	lat.
Ecclesia	lat.
Echange	frz.
Echappade	frz.
Écharpe	frz.
Echaussement	frz.
Échéance	frz.
Échec	frz.
Échelle	frz.
Echelons	frz.
Echinus	grch.
Echo	grch.
École	frz.
Economiser	engl.
Écrasez l'infâme	frz.
Ecu	frz.
Écusson	frz.
Écuyer	frz.
Edidit	lat.
Edieren	lat.
Edíkt	lat.
Edition	lat.
Edom	hebr.
Edredon	frz.
Edukation	lat.
Edúkt	lat.
Edulkorieren	lat.
Eduzieren	lat.
Edward	engl.
Effékt	lat.
Effektiv	lat.
Effektuiren	frz.
Effemination	lat.
Effet	frz.
Effilieren	frz.
Effizieren	lat.
Effloreszénz	lat.
Effronterie	frz.
Egal	frz.
Égalité	frz.
Egg-shells	engl.
Eglomisieren	frz.
Ego	lat.
Egrenieren	frz.
Egyptienne	frz.
Eh bien	frz.
Eidographie	grch.
Eihülle	botan.
Eikon	grch.
Eingeschlechtig	botan.
Einhäusig	botan.
Einweibig	botan.
Eirometer	grch.
Ejakulation	lat.
Ejâlet	arab.
Ejéktor	lat.
Ejizieren	lat.
Ekchymose	grch.
Ekklesia	grch.
Ekklesiástes	grch.
Ekklesiastikus	grch.
Ekkyklema	grch.
Eklaircieren	frz.
Eklampsie	grch.
Eklat	frz.
Eklektiker	grch.
Eklipse	grch.
Eklíptik	grch.
Ekloge	grch.
Ekossaise	frz.
Ekraseur	frz.
Ekretieren	frz.
Ekstase	grch.
Ektasie	grch.
Ektasis	grch.
Ekthyma	grch.
Ektodérm	grch.
Ektoparasiten	grch.
Ektopie	grch.
Ektropium	grch.
Ektypen	grch.
Ekzem	grch.
Elaborat	lat.
Elan	frz.
Eläodorisch	grch.
Eläometer	grch.
Elaterometer	grch.
Eldorado	span.
Eleasar	hebr.
Eléctor	lat.
Electuarium	lat.
Elefantiasis	grch.
Elegánt	frz.
Elegie	grch.
Elektion	lat.
Elektrochemie	grch.
Elektrochemitypie	grch.
Elektroden	grch.
Elektrodiagnóstik	grch.
Elektrodynamik	grch.
Elektrodynamometer	grch.
Elektrographie	grch.
Elektrolyse	grch.
Elektrometallurgie	grch.
Elektrometeore	grch.
Elektrometer	grch.
Elektron	grch.
Elektroóptik	grch.
Elektrophor	grch.
Elektrophysiologie	grch.
Elektroplástik	grch.
Elektropositiv	grch.
Elektrotechnik	grch.
Elektrotherapie	grch.
Elektrotonus	grch.
Elektrotypie	grch.
Elektrum	lat.
Eleménte	lat.
Elénchus	grch.
Eleutheropetalen	botan.
Elevation	lat.
Elevator	lat.
Eleve	frz.
Elevieren	lat.
Elf	schwed.
Elidieren	lat.
Elieser	hebr.
Eligieren	lat.
Elimination	lat.
Elisabeth	hebr.
Elision	lat.
Elite	frz.
Eljen	ungar.
Ellipse	grch.
Ellipsograph	grch.
Eloah	hebr.
Eloge	frz.
Elokution	lat.
Elongation	lat.
Eloquénz	lat.
Eludieren	lat.
Elukubration	lat.
Elusion	lat.
Elution	lat.
Elutriation	lat.
Eluvium	neulat.
Elv	norw.
Email	frz.
Emanation	lat.
Emanieren	lat.
Emanzipation	lat.
Emazerieren	lat.
Emballage	frz.
Embargo	span.
Embarkieren	frz.
Embarras	frz.
Embaterien	grch.
Embellieren	frz.
Emblem	grch.
Embolie	grch.
Embolismus	grch.
Embolus	grch.
Embonpoint	frz.
Embrunieren	frz.
Embryo	grch.
Embryogenie	grch.
Embryologie	grch.
Embryosack	botan.
Embryotomie	grch.
Emendánda	lat.
Emérgens	lat.
Emeritus	lat.
Emersion	lat.
Emente	frz.
Emigranten	lat.
Emine	frz.
Eminént	lat.
Eminénz	lat.
Emir	arab.
Emission	lat.
Emmertropie	grch.
Emolumént	lat.
Emotion	lat.
Empaillieren	frz.
Empâtement	frz.
Empereur	frz.
Emphase	grch.
Emphysem	grch.
Emphyteusis	grch.
Empire	frz.
Empirie	grch.
Emplastrum	lat.
Employé	frz.
Emporium	grch.
Empressement	frz.
Empsychose	grch.
Empyem	grch.
Empyreum	grch.
Empyreumatisch	grch.
Empyromantie	grch.
Emulsion	lat.
Emulsoren	lat.
Enantioblásten	grch.
Enarthrose	grch.
Encablure	frz.
Encadrement	frz.
Enceinte	frz.
Enchantement	frz.
Enchâssure	frz.
Enchiridion	grch.
Enchondrom	grch.
Endecha	span.
Endemie	grch.
Endogamie	grch.
Endokarditis	grch.
Endokarpium	grch.
Endoskop	grch.
Endospérm	grch.
Endothelium	grch.
En écharpe	frz.
Energetik	grch.
Energie	grch.
Enervation	lat.
Enfant	frz.
Enfants de France	frz.
Enfants de troupe	frz.
Enfants perdus	frz.
Enfant terrible	frz.
Enfilade	frz.
Enfin	frz.
Enflammieren	frz.
Enfleurage	frz.
Engagement	frz.
Engastrimánt	grch.
Engobierfarbe	frz.
En grande tenue	frz.
Engrêlure	frz.
En gros	frz.
Engymeter	grch.
Enharmonisch	grch.
Enjambement	frz.
Enkadrieren	frz.
Enkaustik	grch.
Enkephalitis	grch.
Enklaven	frz.
Enklisis	grch.
Enkolpion	grch.
Enkomiástik	grch.
Enkratiten	grch.
Enlevage	frz.
En miniature	frz.
Ennaëteris	grch.
Ennata	grch.
Enneagynisch	grch.
Enneakaidekaëteris	grch.
Enneándrisch	grch.
Ennui	frz.
Enórm	lat.
Enostose	grch.
En passant	frz.
En profil	frz.
Enquete	frz.
Enragiert	frz.
Enregistrement	frz.
Enrhümiert	frz.
Enrichieren	frz.
Enrollieren	frz.
Ensemble	frz.
En suite	frz.
Entasis	grch.
Entelechie	grch.
Entente	frz.
Enteralgie	grch.
Enteritis	grch.
Enterolithen	grch.
Enterologie	grch.
Enteroptose	grch.
Enteroskopie	grch.
Enthelmínthen	grch.
Entheomanie	grch.
Enthusiasmus	grch.
Entität	lat.
Entodérm	grch.
Entóma	grch.
Entomographie	grch.
Entomolithen	grch.
Entomolog	grch.
Entonie	grch.
Entonnoir	frz.
Entoparasiten	grch.
Entophyten	grch.
Entopisch	grch.
Entoptisch	grch.
Entoutcas	frz.
Entozoen	grch.
Entr'acte	frz.
En train	frz.
Entrata	ital.
Entrechat	frz.
Entre-Côte	frz.
Entree	frz.
Entrefilet	frz.
Entrelacs	frz.
Entremes	span.
Entremets	frz.
Entrepot	frz.
Entrepreneur	frz.
Entresol	frz.
Entretenieren	frz.
Entrevue	frz.
Entrez	frz.
Entropie	grch.
Enukleation	lat.
Enumeration	lat.
Enunziation	lat.
Enuresis	grch.
Enveloppe	frz.
Envers	frz.
En vogue	frz.
Envoyé	frz.
Enzyklopädie	grch.
Eo ipso	lat.
Eolithen	grch.
Eozoon canadense	grch.
Epagoge	grch.
Epagomenen	grch.
Epákten	grch.
Epárch	grch.
Epauletten	frz.
Epexegese	grch.
Ephemera	grch.
Ephemeriden	grch.
Ephoren	grch.
Ephraïm	hebr.
Epiblást	grch.
Epicarpium	grch.
Epideiktisch	grch.
Epidemie	grch.
Epidérmis	grch.
Epidiaskop	grch.
Epierreur	frz.
Epigastrium	grch.
Epiglóttis	grch.
Epigonen	grch.
Epigrámm	grch.
Epigraphik	grch.
Epigynisch	grch.
Epik	grch.
Epikárp	botan.
Epilepsie	grch.
Epilog	grch.
Epimeleten	grch.
Epimetheus	grch.
Epimythium	grch.
Epinglé	frz.
Epinikion	grch.
Epiphania	grch.
Epiphora	grch.
Epiphyten	grch.
Epirrhema	grch.
Episcopus	lat.
Episkop	grch.
Episkopal	lat.
Episkopat	lat.
Episoden	grch.
Epístel	grch.
Epistola	lat.
Epistola Pilati	lat.
Epistolar	lat.
Epistropheus	grch.
Epistyl	grch.
Epithalamium	grch.
Epithel	grch.
Epitheliom	grch.
Epitheton	grch.
Epitome	grch.
Epitritus	grch.
Epizoen	grch.
Epizýkel	grch.
Epizykloide	grch.
Epóche	grch.
Epode	grch.
Epopöe	grch.
Epópten	grch.
Epos	grch.
Épreuve	frz.
Epulis	grch.
Epulonen	lat.
Equipage	frz.
Equivoque	frz.
Equus	lat.
Erdö-	ungar.
Erektil	neulat.
Eremit	grch.
Eremitage	frz.
Ergo	lat.
Ergograph	grch.
Ergostat	grch.
Eriometer	grch.
Erístik	grch.
Ermitage	frz.
Eroica	ital.
Eros	grh.
Erosion	lat.
Erotematik	grch.
Erotik	grch.
Erotomanie	grch.
Erpetologie	grch.
Errare humanum est	lat.
Errata	lat.
Erratum	lat.
Error	lat.
Erudition	lat.
Eruieren	lat.
Erumpieren	lat.
Eruption	lat.
Erythem	grch.
Erythrasma	grch.
Erythromelalgie	grch.
Esau	hebr.
Eschatologie	grch.
Esclavage	frz.
Escouade	frz.
Eskadre	frz.
Eskadron	frz.
Eskalade	frz.
Eskamoteur	frz.
Eskapade	frz.
Eskarpe	frz.
Eskarpins	frz.
Eski	türk.
Eskompte	frz.
Eskorte	frz.
Eskulént	lat.
Esoterisch	grch.
Espada	span.
Espadilla	span.
Espadon	frz.
Espagnoletteverschluß	frz.
Espèce	frz.
Espingole	frz.
Espirando	ital.
Esplanade	frz.
Esponton	frz.
Esprit	frz.
Esquire	engl.
Esra	hebr.
Essay	engl.
Esse	lat.
Essedum	lat.
Estafette	frz.
Estakade	frz.
Estaminet	frz.
Estampe	frz.
Estancia	span.
Estelin	frz.
Estimieren	frz.
Estinguéndo	ital.
Estoc	frz.
Estomihi	lat.
Estompe	frz.
Estrade	frz.
Estrapade	frz.
Etablieren	frz.
Etage	frz.
Etagere	frz.
Etalage	frz.
Etalon	frz.
Etamieren	frz.
Etappe	frz.
Etat	frz.
États généraux	frz.
Eteográmm	grch.
Eteostichon	grch.
Ethik	grch.
Ethmoïdeum	grch.
Ethnárch	grch.
Ethologie	grch.
Ethos	grch.
Et in Arcadia ego	lat.
Etiolieren	frz.
Etmal	niederländ.
Ettaro	ital.
Ettogramma	ital.
Etüde	frz.
Etui	frz.
Etymologie	grch.
Eubiotik	grch.
Eucharistie	grch.
Euchologion	grch.
Eudämonie	grch.
Eudiometer	grch.
Euergétes	grch.
Eukrasie	grch.
Eulogie	grch.
Eumeniden	grch.
Eumetrie	grch.
Eunuch	grch.
Eupator	grch.
Euphonie	grch.
Euphrosyne	grch.
Eurhythmie	grch.
Euros	grch.
Eusebie	grch.
Eutérpe	grch.
Euthanasie	grch.
Evakuation	lat.
Evangelium	grch.
Evaporieren	lat.
Evasion	lat.
Evektion	lat.
Evénement	frz.
Even money	engl.
Eversion	lat.
Evéx	lat.
Evidént	lat.
Eviktion	lat.
Evinzieren	lat.
Evoe	lat.
Evokation	lat.
Evolute	lat.
Evolution	lat.
Evolvénte	lat.
Ex	lat.
Ex abrupto	lat.
Exaggeration	lat.
Exákt	lat.
Exaltatio crucis	lat.
Exaltation	lat.
Examen	lat.
Exanthem	grch.
Exárch	grch.
Exartikulation	lat.
Ex asse	lat.
Exaudi	lat.
Ex cathedra Petri	lat.
Exchequer	engl.
Exeat	lat.
Exedra	grch.
Exegese	grch.
Exekrabel	lat.
Exekutabel	lat.
Exekution	lat.
Exekutor	lat.
Exemplar	lat.
Exemplifikation	lat.
Exemtion	lat.
Exenteratio bulbi	lat.
Exequatur	lat.
Exequieren	lat.
Exergue	frz.
Exerzieren	lat.
Exerzitium	lat.
Exeunt	lat.
Exfoliation	lat.
Exhalation	lat.
Exhaustor	lat.
Exhibition	lat.
Exhibition	engl.
Exhortation	lat.
Exhumation	neulat.
Exigieren	lat.
Exil	lat.
Eximieren	lat.
Ex improviso	lat.
Existénz	lat.
Exit	lat.
Ex jure	lat.
Exkalzeaten	lat.
Exkavation	lat.
Exklamation	lat.
Exkludieren	lat.
Exkommunikation	lat.
Exkreménte	lat.
Exkreszénzen	lat.
Exkrete	lat.
Exkulpabel	lat.
Exkúrs	lat.
Exkursion	lat.
Exkusation	lat.
Exkussion	lat.
Exlex	lat.
Exlibris	lat.
Exmatrikulation	lat.
Exmission	lat.
Ex nexu	lat.
Exodium	grch.
Exodus	grch.
Ex officio	lat.
Exogamie	grch.
Exophthálmus	grch.
Exorbitánt	lat.
Exordium	lat.
Exorzisieren	grch.
Exostose	grch.
Exotisch	grch.
Expandieren	lat.
Expansiv	lat.
Ex parte	lat.
Expatriieren	neulat.
Expediens	lat.
Expektoration	lat.
Expensen	lat.
Experiéntia	lat.
Experimént	lat.
Experiméntum	lat.
Expért	lat.
Experto credite	lat.
Expiabel	lat.
Explanation	lat.
Explicit	lat.
Explikation	lat.
Explizite	lat.
Explodieren	lat.
Exploitieren	frz.
Exploration	lat.
Explosion	lat.
Explosiv	lat.
Exponént	lat.
Exponieren	lat.
Exposé	frz.
Exposition	lat.
Expositur	lat.
Expréß	lat.
Ex profésso	lat.
Expromission	lat.
Expropriation	lat.
Expulsion	lat.
Exquisit	lat.
Exsikkation	lat.
Exspektánt	lat.
Exspiration	lat.
Exstinktion	lat.
Exstirpation	lat.
Extemporale	lat.
Extensibel	lat.
Extérn	lat.
Exterritorial	lat.
Extinkteur	frz.
Extra	lat.
Extrados	frz.
Extrahieren	lat.
Extraktion	lat.
Extran	lat.
Extraordinär	lat.
Extrauterin	lat.
Extravagánt	lat.
Extravasat	lat.
Extrem	lat.
Exulánt	lat.
Exulzeration	lat.
Exundation	lat.
Ex ungue leonem	lat.
Exuvien	lat.
Ex voto	lat.
Exzedént	lat.
Exzellént	lat.
Exzellénz	lat.
Exzellieren	lat.
Exzelsior	lat.
Exzentrisch	neulat.
Exzentrizität	neulat.
Exzeption	lat.
Exzerpieren	lat.
Exzéß	lat.
Ezechiel	hebr.
Faba	lat.
Fabian Society	engl.
Fableaux	frz.
Fable convenue	frz.
Fabliaux	frz.
Fabrica ecclesiae	lat.
Fabula	lat.
Face	frz.
Faeces	lat.
Facetten	frz.
Facies	lat.
Facio ut des	lat.
Façon	frz.
Facta	lat.
Factitiva	lat.
Facto	lat.
Factory weight	engl.
Factum	lat.
Facultas	lat.
Fadaise	frz.
Fagótt	ital.
Fagus	lat.
Faiblage	frz.
Faible	frz.
Faille	frz.
Fainéant	frz.
Fair	engl.
Faiseur	frz.
Fait	frz.
Fakîr	arab.
Faksimile	lat.
Faktion	lat.
Faktor	lat.
Faktotum	lat.
Fäkulént	lat.
Fakultät	lat.
Fakultativ	lat.
Falarika	lat.
Falco	lat.
Falkieren	frz.
Fall	engl.
Fallbrücke	grch.
Fallimént	ital.
Falsarius	lat.
Falsifizieren	lat.
Falsum	lat.
Falu	ungar.
Fameusen	frz.
Familiär	lat.
Familie	lat.
Familistère	frz.
Famos	lat.
Famulus	lat.
Fanal	ital.
Fanatismus	lat.
Fancy	engl.
Fanfare	frz.
Fanfaron	frz.
Fango	ital.
Fanon	frz.
Fant	ital.
Faquin	frz.
Farce	frz.
Farina	lat.
Farm	engl.
Faro	ital.
Faser	botan.
Fashion	engl.
Fassion	lat.
Fassonieren	frz.
Fastidiös	lat.
Faszikel	lat.
Faszination	lat.
Fatal	lat.
Fata Morgana	ital.
Fatieren	lat.
Fatigieren	lat.
Fattura	ital.
Fatum	lat.
Faubourg	frz.
Fauna	neulat.
Fausse alarme	frz.
Faute	frz.
Fauteuil	frz.
Faux	frz.
Favete linguis	lat.
Faveur	frz.
Favorisieren	frz.
Fayence	frz.
Fazenda	portug.
Fazetien	lat.
Fazial	lat.
Fazies	lat.
Febril	lat.
Febris	lat.
Fecit	lat.
Federchen	botan.
Feerie	frz.
Feet	engl.
Felis	lat.
Felizitieren	frz.
Fellow	engl.
Felonie	kelt.
Feluke	ital.
Femina	lat.
Femme	frz.
Femur	lat.
Fender	engl.
Ferda	arab.
Ferîk	arab.
Ferm	frz.
Ferma in posta	ital.
Fermân	pers.
Fermate	ital.
Ferme	frz.
Fermentation	lat.
Ferménte	lat.
Fernando	span.
Feroce	ital.
Ferozität	lat.
Ferrasch	arab.
Fersakh-â'chary	türk.
Fertil	lat.
Festivität	lat.
Festivo	ital.
Feston	frz.
Fetieren	frz.
Fetwa	arab.
Feudum	mittellat.
Feuillants	frz.
Feuilleton	frz.
Feuillette	frz.
Fiale	grch.
Fiasko	ital.
Fiat	lat.
Fibern	lat.
Fibula	lat.
Fiche	frz.
Fichu	frz.
Fidalgo	portug.
Fideïkommíß	lat.
Fidelissimus	lat.
Fidelitas	lat.
Fidemieren	lat.
Fides	lat.
Fiducia	lat.
Fiëraménte	ital.
Fiëranten	ital.
Figur	lat.
Figuránten	lat.
Figuration	lat.
Figurativ	lat.
Figurieren	lat.
Figurine	lat.
Fikh	arab.
Fiktil	lat.
Fiktion	lat.
Filamént	lat.
Filanda	ital.
Filatorium	lat.
Filet	frz.
Filia	lat.
Filiation	lat.
Filieren	frz.
Filifórm	neulat.
Filioque	lat.
Filius	lat.
Fille	frz.
Film	engl.
Filoselle	frz.
Filou	frz.
Fils	frz.
Filtrieren	lat.
Filure	frz.
Fimbrien	lat.
Final	lat.
Finale	ital.
Fin de siècle	frz.
Fine	ital.
Fines herbes	frz.
Finesse	frz.
Fingieren	lat.
Finieren	lat.
Finis	lat.
Finish	engl.
Finis Poloniae!	lat.
Finissage	frz.
Finissimo	ital.
Finocchio	ital.
Fiorino	ital.
Fire-test	engl.
Firm	lat.
Firma	ital.
Firmamént	lat.
Firmität	lat.
Firth	schott.
Fiskal	lat.
Fiskus	lat.
Fissil	lat.
Fissipeden	lat.
Fissur	lat.
Fittings	engl.
Five o'clock tea	engl.
Fix	lat.
Fixieren	lat.
Fixum	lat.
Fjäll	schwed.
Fjärd	schwed.
Fjord	dän.
Flageolett	frz.
Flagránt	lat.
Flambeau	frz.
Flammula	lat.
Flanell	frz.
Flanieren	frz.
Flatterie	frz.
Flatteur	frz.
Flatulént	lat.
Flèche	frz.
Flektieren	lat.
Fleur	frz.
Fleuret	frz.
Fleuretten	frz.
Fleurist	frz.
Fleuron	frz.
Flexibel	lat.
Flexion	lat.
Flexor	lat.
Floconné	frz.
Flor	lat.
Floreat!	lat.
Florence	frz.
Floreszénz	lat.
Florieren	lat.
Florilegium	lat.
Florin	frz.
Flos	lat.
Floskel	lat.
Flottieren	frz.
Flottille	frz.
Fluid	lat.
Fluidität	lat.
Fluid meat	engl.
Fluid ozone	engl.
Fluidum	lat.
Fluktuation	lat.
Fluor albus	lat.
Fluoreszénz	neulat.
Fluvial	lat.
Fluxion	lat.
Flyer	engl.
Föderalismus	lat.
Föderation	lat.
Fökúnd	lat.
Fokus	lat.
Földvár	ungar.
Folio	ital.
Folkething	dän.
Folklore	engl.
Follikel	lat.
Fomalhaut	arab.
Fomént	lat.
Foncé	frz.
Fond	frz.
Fonda	span.
Fonds	frz.
Fontaine	frz.
Fontanellen	lat.
Fontange	frz.
Foot	engl.
Foot-ball	engl.
Fop	engl.
Force	frz.
Forceps	lat.
Forcieren	frz.
Foreign Office	engl.
Forénsisch	lat.
Forestiere	ital.
For ever	engl.
Forfeit	engl.
Forma	lat.
Formabel	lat.
Formal	lat.
Formarius	lat.
Format	lat.
Formation	lat.
Formell	frz.
Formica	lat.
Formidabel	lat.
Formieren	lat.
Formikation	lat.
Formular	neulat.
Fornarina	ital.
Forsunka	russ.
Fort	frz.
Forte	ital.
Fortepiano	ital.
Fortifikation	lat.
Fortis	lat.
Fortissimo	ital.
Fortiter	lat.
Fortuna	lat.
Forza	ital.
Fossa	lat.
Fossilien	lat.
Fötus	lat.
Fou	frz.
Foudre	frz.
Fougassen	frz.
Foulard	frz.
Fourchette	frz.
Fovieren	lat.
Foxterrier	engl.
Foyer	frz.
Fra	ital.
Fra Diavolo	ital.
Fragil	lat.
Fragmént	lat.
Fraktion	lat.
Fraktokumulus	lat.
Fraktur	lat.
Française	frz.
Francesco	ital.
Franchise	frz.
François	frz.
Frange	frz.
Frankieren	ital.
Franko	ital.
Frappánt	frz.
Frasco	span.
Frate	ital.
Frater	lat.
Fraudation	lat.
Fraxinus	lat.
Free church	engl.
Free-masonry	engl.
Freesoilers	engl.
Free-trade	engl.
Frelatieren	frz.
Frequént	lat.
Friendly Societies	engl.
Frigid	lat.
Frikassée	frz.
Friktion	lat.
Fripon	frz.
Frisé	frz.
Friseur	frz.
Frittaten	ital.
Frivol	lat.
Fromage	frz.
Frondos	lat.
Frons	lat.
Fronton	frz.
Frotté d'or	frz.
Frottieren	frz.
Frugal	lat.
Fruktifikation	lat.
Frustration	lat.
Frutti	ital.
Fugato	ital.
Fugazität	lat.
Fughetta	ital.
Fulgént	lat.
Fulguration	lat.
Full dress	engl.
Fulminieren	lat.
Fumarolen	ital.
Fumigation	lat.
Fumoir	frz.
Fund	engl.
Fundamént	lat.
Fundation	lat.
Fundieren	lat.
Fundus	lat.
Funebral	lat.
Funeralien	lat.
Fungi	lat.
Fungieren	lat.
Fungös	lat.
Fungus	lat.
Funktion	lat.
Fuocoso	ital.
Furagieren	frz.
Furia francese	ital.
Furioso	ital.
Furnieren	frz.
Furor	lat.
Furore	ital.
Furunkel	lat.
Füsilieren	frz.
Fusion	lat.
Fusti	ital.
Fustigation	mittellat.
Futaille	frz.
Futil	lat.
Futurum	lat.
Fylfot	altengl.
Gabella	mittellat.
Gabriel	hebr.
Gad	hebr.
Gage	frz.
Gagisten	frz.
Gaillarde	frz.
Gala	span.
Galáktisch	grch.
Galaktocele	grch.
Galan	span.
Galánt	frz.
Galanterie	frz.
Galant homme	frz.
Galantuómo	ital.
Galaxias	grch.
Galipot	frz.
Galla	arab.
Gallicus morbus	lat.
Gallus	lat.
Galons	frz.
Galopin	frz.
Galopp	frz.
Gamaschen	frz.
Gamin	frz.
Gamopetalen	botan.
Ganglien	grch.
Ganglion	grch.
Ganivet	frz.
Garage	frz.
Garance	frz.
Garantie	frz.
Garbanzos	span.
Garçon	frz.
Garde	frz.
Gardedukorps	frz.
Garderobe	frz.
Gardez	frz.
Gargarísma	grch.
Garnieren	frz.
Garnison	frz.
Garnitur	frz.
Garrotte	frz.
Gasel	arab.
Gaster	grch.
Gastralgie	grch.
Gastrektasie	grch.
Gastrilogie	grch.
Gastrisch	grch.
Gastrodiaphanie	grch.
Gastroenteritis	grch.
Gastroenterostomie	grch.
Gastrologie	grch.
Gastromalazie	grch.
Gastronomie	grch.
Gastroskopie	grch.
Gastrosophie	grch.
Gastrospasmus	grch.
Gastrostomie	grch.
Gastrotomie	grch.
Gaudeamus	lat.
Gaudium	lat.
Gaufrieren	frz.
Gaulois	frz.
Gault	engl.
Gave	frz.
Gaze	frz.
Gazetta	ital.
Gazeux	frz.
Gebern	pers.
Gelasmus	grch.
Gelatine	lat.
Gelee	frz.
Gemination	lat.
Gemini	lat.
Genánt	frz.
Gendarmen	frz.
Genealogie	grch.
Genera	lat.
Generalisation	lat.
Generalissimus	lat.
Generalität	lat.
Generation	lat.
Generator	lat.
Generell	lat.
Generisch	lat.
Generös	frz.
Genesis	grch.
Genetisch	grch.
Genette	frz.
Genial	lat.
Genie	frz.
Genien	lat.
Genieren	frz.
Genitalien	lat.
Genitiv	lat.
Genius	lat.
Genre	frz.
Gens	lat.
Gentes	lat.
Gentil	frz.
Gentilhomme	frz.
Gentilismus	lat.
Gentleman	engl.
Gentry	engl.
Genu	lat.
Genuin	lat.
Genus	lat.
Geodäsie	grch.
Geoden	grch.
Geodynamik	grch.
Geognosie	grch.
Geographie	grch.
Geologie	grch.
Geomantie	grch.
Geometer	grch.
Geometrie	grch.
Geonomie	grch.
Geophagen	grch.
Geoplástik	grch.
Georama	grch.
Geostatik	grch.
Geotektonik	grch.
Geothermometer	grch.
Geotropismus	grch.
Geozéntrisch	grch.
Gerant	frz.
Gerieren	lat.
German silver	engl.
Germany	engl.
Germen	lat.
Germination	lat.
Gerónten	grch.
Gerontóxon	grch.
Gerra	span.
Gesta	lat.
Gestation	lat.
Gestikulation	lat.
Gestion	lat.
Ghazâ	türk.
Ghetto	ital.
Giallo	ital.
Gibus	frz.
Giga	ital.
Gigue	frz.
Gihon	hebr.
Gilde	altgerman.
Gilet	frz.
Gin	engl.
Gingerbeer	engl.
Giocoso	ital.
Gipsy	engl.
Girande	frz.
Girandole	frz.
Girasol	frz.
Girl	russ.
Giro	ital.
Gitano	span.
Giusto	ital.
Glace	frz.
Glacerie	frz.
Glacier	frz.
Glacis	frz.
Gladiatoren	lat.
Glandulae	lat.
Glans	lat.
Glaukom	grch.
Glaukopis	grch.
Gleba	lat.
Glebae adscriptus	lat.
Gleukometer	grch.
Gliadin	grch.
Gliom	grch.
Glirarien	lat.
Glissade	frz.
Globetrotter	engl.
Globos	lat.
Globuli	lat.
Globulus	lat.
Globus	lat.
Globus hystericus	lat.
Gloire	frz.
Gloria	lat.
Glorie	lat.
Gloriette	frz.
Glorifikation	lat.
Glossa	grch.
Glosse	grch.
Glossitis	grch.
Glossolalie	grch.
Glottik	grch.
Glottis	grch.
Glutinös	lat.
Glykosurie	grch.
Glyphogenie	grch.
Glyphographie	grch.
Glyptik	grch.
Gnathalgie	grch.
Gnome	grch.
Gnomen	frz.
Gnomon	grch.
Gnosis	grch.
Gnothi seautón	grch.
Gobelet	frz.
Godron	frz.
Goguettes	frz.
Gold Coast	engl.
Gonagra	grch.
Gonfalone	ital.
Goniometer	grch.
Goniometrie	grch.
Gonitis	grch.
Gonochorismus	grch.
Gonorrhöe	grch.
Good bye	engl.
Goralen	slaw.
Gorgeret	frz.
Górod	russ.
Gospodár	slaw.
Gouachemalerei	frz.
Gourmand	frz.
Goût	frz.
Goutte	frz.
Gouvernante	frz.
Gouvernement	frz.
Gouverneur	frz.
Governatore	ital.
Governor	engl.
Grabeau	frz.
Gracht	holländ.
Graecia	lat.
Gradatim	lat.
Gradation	lat.
Graduale	neulat.
Graduéll	frz.
Graduieren	frz.
Gradus	lat.
Grain	frz.
Graines	frz.
Gräkomanie	grch.
Grammátik	grch.
Grammophon	grch.
Grand-duc	frz.
Grandeur	frz.
Grandeza	span.
Grandios	ital.
Grand-Seigneur	frz.
Granite-ware	engl.
Granulation	lat.
Granulieren	lat.
Granulös	lat.
Granum	lat.
Graphik	grch.
Graphisch	grch.
Grapholith	grch.
Graphologie	grch.
Graphophon	grch.
Graphospásmus	grch.
Graphostatik	grch.
Graphotypie	grch.
Grassieren	lat.
Gratia	lat.
Gratial	neulat.
Gratias	lat.
Gratifikation	lat.
Gratis	lat.
Gratulánt	lat.
Gravantia	lat.
Grave	ital.
Graveur	frz.
Gravieren	lat.
Gravieren	frz.
Gravis	lat.
Gravität	lat.
Gravitation	neulat.
Gravüre	frz.
Graziös	lat.
Green Mountains	engl.
Grège	frz.
Grein	niederländ.
Gremiale	neulat.
Gremium	lat.
Grenadine	frz.
Grenaille	frz.
Grève	frz.
Grevíst	frz.
Greyhound	engl.
Griblette	frz.
Griffonnage	frz.
Grillade	frz.
Grillieren	frz.
Grill-room	engl.
Griotte	frz.
Griphus	grch.
Grisaille	frz.
Grisette	frz.
Griveliert	frz.
Groom	engl.
Gros	frz.
Grosserie	frz.
Grossesse nerveuse	frz.
Gros tournois	frz.
Grotesken	ital.
Grouse	engl.
Grubber	engl.
Gryphus	lat.
Guadalaviar	arab.
Guardian	ital.
Gubernakel	lat.
Gubernator	lat.
Gubernium	neulat.
Gueridon	frz.
Guerre	frz.
Guiden	frz.
Guidon	frz.
Guiliélmus	lat.
Guillochieren	frz.
Guillotine	frz.
Guinea	engl.
Gully	engl.
Gulyás	ungar.
Gunnibags	engl.
Gunny	engl.
Gustieren	lat.
Gusto	ital.
Gustus	lat.
Gutta	lat.
Guttatim	lat.
Gymkhana	ind.
Gymnosophisten	grch.
Gymnospérmen	grch.
Gynäkokratie	grch.
Gynäkologie	grch.
Gynäkoman	grch.
Gynäkomást	grch.
Gyri	lat.
Gyromantie	grch.
Gyrometer	grch.
Gyroskop	grch.
Gyrotrop	grch.
Habakuk	hebr.
Habil	lat.
Habillieren	frz.
Habit	lat.
Habitabel	lat.
Habitué	frz.
Habituéll	frz.
Habitus	lat.
Hacienda	span.
Hadîth	arab.
Hadschi	arab.
Haggada	hebr.
Haggaï	hebr.
Hagiasmós	grch.
Hagiographa	grch.
Hagiolatrie	grch.
Hagioskop	grch.
Hagiotik	grch.
Haïk	arab.
Haircord	engl.
Hakîm	arab.
Halacha	hebr.
Half-breeds	engl.
Half-penny	engl.
Halieutik	grch.
Haliplankton	grch.
Hälleflinta	schweb.
Halleluja	hebr.
Halluzinationen	lat.
Halma	grch.
Halochemie	grch.
Halogene	grch.
Halometer	grch.
Halophyten	grch.
Halotechnik	grch.
Halteren	grch.
Halurgie	grch.
Halwa	arab.
Hamaaloth	hebr.
Hämagoga	grch.
Hamam	arab.
Hämatemesis	grch.
Hämatinon	grch.
Hämatoblasten	grch.
Hämatokathartika	grch.
Hämatom	grch.
Hämatonosen	grch.
Hämatose	grch.
Hämatostatik	grch.
Hämatozoen	grch.
Hämaturie	grch.
Hamaxobier	grch.
Hammada	arab.
Hammâl	arab.
Hämoglobinurie	grch.
Hämometer	grch.
Hämopathologie	grch.
Hämorrhagie	grch.
Hämorrhoiden	grch.
Hämorrhophilie	grch.
Hämostase	grch.
Handikap	engl.
Hangard	frz.
Han-hai	chines.
Hansom	engl.
Hapax legomenon	grch.
Haphtara	hebr.
Haptisch	grch.
Haquenées	frz.
Harambascha	türk.
Harangieren	frz.
Häresie	grch.
Harmonie	grch.
Harmonieren	grch.
Harmonik	grch.
Harmonisch	grch.
Harpago	lat.
Harry	engl.
Harselieren	frz.
Haschisch	arab.
Hasnadar Baschi	türk.
Hasnadar Kadyn	türk.
Hasta	lat.
Hastati	lat.
Hato	span.
Hausse	frz.
Haustorien	neulat.
Haut-de-chausse	frz.
Hautefinance	frz.
Hautesse	frz.
Hautevolee	frz.
Hautgout	frz.
Hautrelief	frz.
Hebephrenie	grch.
Hedschra	arab.
Hegemonie	grch.
Hegumenos	neugrch.
Hekatómbe	grch.
Héktik	grch.
Hektograph	grch.
Helecho	span.
Heliochromie	grch.
Heliograph	grch.
Heliographie	grch.
Heliometer	grch.
Helioplástik	grch.
Heliosis	grch.
Helioskop	grch.
Heliostat	grch.
Heliotherapie	grch.
Heliothermometer	grch.
Heliotrop	grch.
Heliotropismus	grch.
Heliotypie	grch.
Heliozéntrisch	grch.
Helkologie	grch.
Hellanodiken	grch.
Hellenomanie	grch.
Hellespónt	grch.
Helminthen	grch.
Hemeralopie	grch.
Hemi...	grch.
Hemiëdrie	grch.
Hemiopie	grch.
Hemisphäre	grch.
Hemistichion	grch.
Hemitropie	grch.
Hendekasyllaben	grch.
Hennin	frz.
Henoch	hebr.
Henotikon	grch.
Henri	frz.
Henriquatre	frz.
Henry	engl.
Heortologie	grch.
Hepatalgie	grch.
Hepatisch	grch.
Heptaemeron	grch.
Heptagon	grch.
Heptagynisch	grch.
Heptameron	grch.
Heptameter	grch.
Heptándrisch	grch.
Heptarchie	grch.
Heptateuch	grch.
Heráldik	grch.
Herbarium	lat.
Herbiferisch	lat.
Heres	lat.
Hermandad	span.
Hermaphroditismus	grch.
Hermen	grch.
Hermeneutik	grch.
Hernia	lat.
Heroide	grch.
Heroon	grch.
Heros	grch.
Herpes	grch.
Hesperos	grch.
Hessian	engl.
Hesychásten	grch.
Hetären	grch.
Hetärie	grch.
Hetero...	grch.
Heterodónt	grch.
Heterodóx	grch.
Heterodynamisch	grch.
Heterogen	grch.
Heterokliton	grch.
Heteromer	grch.
Heteromórph	grch.
Heteromorphismus	grch.
Heteronomie	grch.
Heterotrop	grch.
Heterozérk	grch.
Heúreka	grch.
Heurístik	grch.
Hexachórd	grch.
Hexadisch	grch.
Hexaeder	grch.
Hexaemeron	grch.
Hexagon	grch.
Hexagrámm	grch.
Hexagynisch	grch.
Hexakisoktaeder	grch.
Hexameron	grch.
Hexameter	grch.
Hexándrisch	grch.
Hexapla	grch.
Hexapóda	grch.
Hiatus	lat.
Hibernal	lat.
Hidalgo	span.
Hide of Land	engl.
Hiëmal	lat.
Hiërarchie	grch.
Hiëratisch	grch.
Hiërodulen	grch.
Hiëroglyphen	grch.
Hiërographa	grch.
Hiërokratie	grch.
Hiëromantie	grch.
Hiëromonachos	grch.
Hiëroskopie	grch.
Hiërothek	grch.
Hiërothet	grch.
High Commission	engl.
Highland	engl.
Highlife	engl.
Highneß	engl.
High Steward	engl.
High Tory	engl.
Hilarotragödie	grch.
Hilus	lat.
Hinc illae lacrimae	lat.
Hippanthrop	grch.
Hippárch	grch.
Hippeis	grch.
Hippiater	grch.
Hippodrom	grch.
Hippogryph	grch.
Hippokámpen	grch.
Hippokrene	grch.
Hippolog	grch.
Hippomachie	grch.
Hippomanie	grch.
Hippus	grch.
Hirka-i-Scherîf	arab.
Hirudo	lat.
Hirundo	lat.
Hispania	lat.
Hispid	lat.
Hissarlik	türk.
Histiologie	grch.
Histogenese	grch.
Histoire	frz.
Histologie	grch.
Histometer	grch.
Historik	grch.
Historiograph	grch.
Historisch	grch.
Hodometer	grch.
Hoeks	niederländ.
Holoedrisch	grch.
Holosterik	grch.
Holy	engl.
Homagial	mittellat.
Hombre	frz.
Home	engl.
Homerule	engl.
Homiletik	grch.
Homilie	grch.
Homme	frz.
Homo	lat.
Homo...	grch.
Homodónt	grch.
Homogen	grch.
Homolog	grch.
Homologumena	grch.
Homonym	grch.
Homöomerie	grch.
Homöopathie	grch.
Homo sapiens	lat.
Homoseisten	grch.
Homousios	grch.
Homozérk	grch.
Homunculus	lat.
Hón	ungar.
Honneurs	frz.
Honoránt	lat.
Honorar	lat.
Honorat	lat.
Honoration	lat.
Honoratioren	lat.
Honorieren	lat.
Honoris causa	lat.
Honourable	engl.
Honvéd	ungar.
Hoofd	niederländ.
Hoplit	grch.
Hora	lat.
Hordeolum	lat.
Hordeum	lat.
Horizónt	grch.
Hornpipe	engl.
Horologium	grch.
Horometer	grch.
Horópter	grch.
Horoskop	grch.
Horreur	frz.
Horribile dictu	lat.
Horribile visu	lat.
Horrid	lat.
Horror	lat.
Hors concours	frz.
Hors d' uvre	frz.
Horse-guards	engl.
Horse-power	engl.
Hortation	lat.
Hortikultur	neulat.
Hortus deliciarum	lat.
Hortus siccus	lat.
Hosea	hebr.
Hospitalität	lat.
Hospitieren	lat.
Hospodar	slaw.
Hostil	lat.
Hotel	frz.
Hotspur	engl.
Hourvari	frz.
Huile	frz.
Huissier	frz.
Human	lat.
Humaniora	lat.
Humanisieren	frz.
Humanitär	frz.
Humanität	lat.
Humerale	lat.
Humid	lat.
Humifikation	lat.
Humiliánt	lat.
Humor	lat.
Humoral	lat.
Humos	lat.
Humus	lat.
Hunter	engl.
Hurdy-gurdy	engl.
Huris	arab.
Hus	tschech.
Hustings	engl.
Hyacinthus	mythol.
Hyalitis	grch.
Hyalographie	grch.
Hyalotypie	grch.
Hyder	grch.
Hýdor	grch.
Hydránt	grch.
Hydrargyrum	grch.
Hydrat	grch.
Hydraulik	grch.
Hydriatrik	grch.
Hydrobat	grch.
Hydrocele	grch.
Hydrographie	grch.
Hydrologie	grch.
Hydromechanik	grch.
Hydrometrie	grch.
Hydropath	grch.
Hydroperikardium	grch.
Hydrophobie	grch.
Hydrophon	grch.
Hydroskopie	grch.
Hydrosphäre	grch.
Hydrostatik	grch.
Hydrotéchnik	grch.
Hydrotherapie	grch.
Hydrothorax	grch.
Hydrozephalus	grch.
Hyetometer	grch.
Hygro...	grch.
Hygrometer	grch.
Hyle	grch.
Hylozoísmus	grch.
Hymnik	grch.
Hypallage	grch.
Hypánte	grch.
Hypaspísten	grch.
Hyper...	grch.
Hyperämie	grch.
Hyperästhesie	grch.
Hypérbel	grch.
Hyperboreer	grch.
Hyperdakytlie	grch.
Hyperkataléktisch	grch.
Hyperkritik	grch.
Hypermeter	grch.
Hyperocha	grch.
Hyperostose	grch.
Hyperplasie	grch.
Hypertrophie	grch.
Hyphe	grch.
Hyphén	grch.
Hypnobat	grch.
Hypnose	grch.
Hypnotika	grch.
Hypnotismus	grch.
Hypoblást	grch.
Hypochondrie	grch.
Hypochondrium	grch.
Hypodermatisch	grch.
Hypogastrium	grch.
Hypogäum	grch.
Hypogynisch	grch.
Hypokaustum	grch.
Hypokras	grch.
Hypokrisie	grch.
Hypomochlium	grch.
Hypospadie	grch.
Hypostase	grch.
Hypotenuse	grch.
Hypothek	grch.
Hypothese	grch.
Hypsometer	grch.
Hysterie	grch.
Hysteron proteron	grch.
Hysterophor	grch.
Iambus	grch.
Iatromathematik	grch.
Ibex	lat.
Ibidem	lat.
Ibn	arab.
Icariens	frz.
Ichthyodónten	grch.
Ichthyolithen	grch.
Ichthyophagen	grch.
Ichthyosis	grch.
Ichthys	grch.
Icterus	grch.
'Id	arab.
Idee	grch.
Idem	lat.
Identität	neulat.
Ideographie	grch.
Ideolog	grch.
Id est	lat.
Idiolatrie	grch.
Idiom	grch.
Idiosynkrasie	grch.
Idiot	grch.
Idol	grch.
Igni et ferro	lat.
Ignipunktur	lat.
Ignis et aquae interdictio	lat.
Ignorabimus	lat.
Ignoránt	lat.
Iguman	neugrch.
Ihrâm	arab.
Ikosaeder	grch.
Ikosándrisch	grch.
Ikositetraeder	grch.
Ikrá	russ.
Iktus	lat.
Ilárch	grch.
Ile	grch.
Ile	frz.
Ileum	grch.
Ilia	lat.
Iliupersis	grch.
Illegal	neulat.
Illegitim	lat.
Illiberal	lat.
Illimitiert	lat.
Illiterat	lat.
Illoyal	frz.
Illuminaten	lat.
Illumination	lat.
Illusion	lat.
Illustration	lat.
Illustre	frz.
Illustris	lat.
Imaginabel	lat.
Imaginär	lat.
Imagination	lat.
Imago	lat.
Imâm	arab.
Imân	arab.
Imarets	arab.
Imbezill	lat.
Imbibition	lat.
Imbroglio	ital.
Imitatio Christi	lat.
Imitation	lat.
Immakulat	lat.
Immanént	lat.
Immaterial	neulat.
Immatrikulation	lat.
Immediat	lat.
Imméns	lat.
Immensurabel	lat.
Immergieren	lat.
Immersion	lat.
Immigránt	lat.
Imminént	lat.
Immission	lat.
Immobil	lat.
Immoralisch	neulat.
Immortalität	lat.
Immortellen	frz.
Immunität	lat.
Impassabel	frz.
Impasto	ital.
Impeachment	engl.
Impenetrabel	lat.
Imperator	lat.
Imperatorisch	lat.
Imperatrix	lat.
Imperfekt	lat.
Imperforabel	neulat.
Imperial	lat.
Impériale	frz.
Imperialismus	neulat.
Imperium	lat.
Impersonale	lat.
Impertinént	lat.
Imperzeptibel	frz.
Impetigo	lat.
Impetuoso	ital.
Impietät	lat.
Implizite	lat.
Impluvium	lat.
Imponderabel	lat.
Imponieren	lat.
Impórt	lat.
Imposánt	frz.
Impossibel	lat.
Impóst	mittellat.
Impotént	lat.
Impresario	ital.
Impression	lat.
Imprimatur	lat.
Impromptu	frz.
Improvisieren	frz.
Impúls	lat.
Impunität	lat.
Imputation	lat.
In absentia	lat.
In abstracto	lat.
Inadäquat	lat.
Inaktiv	lat.
Inakzeptabel	lat.
Inanition	lat.
Inappellabel	neulat.
In armis	lat.
Inartikuliert	lat.
In aetérnum	lat.
Inauguration	lat.
Inchoativa	lat.
In coena Domini	lat.
In concreto	lat.
In contumaciam	lat.
In corpore	lat.
Incroyable	frz.
Incusi	lat.
Indeclinabilia	lat.
Indefinitum	lat.
Indeklinabel	lat.
Indelikat	neulat.
Indemnität	lat.
Indent	engl.
Independénten	neulat.
In deposito	lat.
Indeterminiert	lat.
Index	lat.
Indezént	lat.
Indian grass	engl.
Indian mail	engl.
Indienne	frz.
Indifferént	lat.
Indigen	lat.
Indigestion	lat.
Indignation	lat.
Indikation	lat.
Indikativ	lat.
Indikator	lat.
Indiktion	lat.
Indirekt	lat.
Indiskret	lat.
Indiskutabel	neulat.
Indisponibel	neulat.
Indisputabel	lat.
Indiszipliniert	lat.
Individuéll	lat.
Indizieren	lat.
Indolént	lat.
In dorso	ital.
In dubio	lat.
Induktion	lat.
Induktiv	lat.
Indúktor	lat.
In dulci jubilo	lat.
Indulgénz	lat.
Indúlt	lat.
In duplo	lat.
Industrial partnership	engl.
Industrie	lat.
Induzieren	lat.
Inedita	lat.
In effigie	lat.
In evangelicis	lat.
Inexákt	frz.
Inexpressibles	engl.
In exténso	lat.
In extremis	lat.
Infallibel	neulat.
Infam	lat.
Infárkt	lat.
Infektion	lat.
Inferiorität	lat.
Infibulation	lat.
Infideles	lat.
In fidem	lat.
Infiltration	neulat.
Infinitiv	lat.
Infix	lat.
Infizieren	lat.
In flagránti	lat.
Inflammabel	lat.
Inflationisten	engl.
Infléktor	lat.
Inflexibel	lat.
Inflexion	lat.
Infloreszénz	lat.
Influénz	neulat.
Influénza	ital.
In folio	lat.
In forma	lat.
Information	lat.
Informität	lat.
Infraktion	lat.
Infralapsarier	neulat.
In full dress	engl.
Infundieren	lat.
Infusion	lat.
Infusum	lat.
In genere	lat.
Ingeneriert	lat.
Ingenieur	frz.
Ingeniös	lat.
Ingenium	lat.
Ingénue	frz.
Ingenuität	lat.
Ingerénz	lat.
Ingesta	lat.
Ingots	engl.
Ingrainfarben	engl.
Ingréß	lat.
Ingrossieren	neulat.
In grosso	ital.
Inguinal	lat.
Inhalation	lat.
Inhärént	lat.
Inhibieren	lat.
In hoc signo vinces	lat.
In honorem	lat.
Inhuman	lat.
In infinitum	lat.
Iniquität	lat.
Initia	lat.
Initialen	lat.
Initiative	lat.
Injektion	lat.
Injéktor	lat.
Injunktion	lat.
Injurie	lat.
Inkandeszénz	lat.
Inkapabel	lat.
Inkarnat	ital.
Inkarnation	neulat.
Inkarzeration	neulat.
Inkasso	ital.
Inklination	lat.
Inkludieren	lat.
Inkognito	ital.
Inkohärént	lat.
Inkolat	lat.
Inkommensurabel	lat.
Inkommodieren	lat.
Inkomparabel	lat.
Inkompatibel	frz.
Inkompetént	neulat.
Inkomplett	lat.
Inkomprehensibel	lat.
Inkonfórm	neulat.
Inkongruént	lat.
Inkonsequént	lat.
Inkonsistént	neulat.
Inkonstánt	lat.
Inkonstitutionéll	frz.
Inkontestabel	neulat.
Inkontinént	lat.
Inkorporation	lat.
Inkorrekt	lat.
Inkrimination	neulat.
Inkubation	lat.
Inkubus	lat.
Inkulpánt	lat.
Inkurabel	neulat.
Inlet	engl.
Inlett	niederd.
Inn	engl.
In natura	lat.
Innervation	neulat.
Innominatkontrakt	lat.
In nomine	lat.
Innovation	lat.
Innozenz	lat.
In nuce	lat.
Inoffensiv	neulat.
Inoffiziös	lat.
Inokkupiert	neulat.
Inokulation	lat.
Inopportun	lat.
Inquilin	lat.
Inquirént	lat.
Inquisition	lat.
Inquisitor	lat.
Inrotulieren	neulat.
In saldo	ital.
Infalieren	ital.
Insalivation	neulat.
Insalubrität	lat.
In salvo	lat.
Insania	lat.
Inschallâh	arab.
Insekten	lat.
Insensibel	lat.
Inseparabel	lat.
Inséparables	frz.
Inserieren	lat.
Insidien	lat.
Insignien	lat.
Insimulieren	lat.
Insinuation	lat.
Insipid	lat.
Inskribieren	lat.
Inskription	lat.
Insolation	lat.
Insolént	lat.
Insolubel	lat.
Insolvént	lat.
Insoziabel	lat.
In spe	lat.
Inspektion	lat.
Inspersion	lat.
Inspiration	lat.
Inspirieren	lat.
Inspizieren	lat.
Instabil	lat.
Installation	neulat.
Instánt	lat.
Instánz	lat.
In statu quo	lat.
Instauration	lat.
Instillation	lat.
Instínkt	lat.
In stirpes	lat.
Institor	lat.
Instituieren	lat.
Institution	lat.
Instradieren	ital.
Instruieren	lat.
Instrumént	lat.
Instrumentalis	lat.
Insubordination	neulat.
Insuffiziénz	lat.
Insufflation	lat.
In summa	lat.
Insurgieren	lat.
In suspénso	lat.
Intabulation	neulat.
Intákt	lat.
Intavolieren	ital.
Integral	neulat.
Integrieren	lat.
Integumént	lat.
Intellékt	lat.
Intelligént	lat.
Intelligibel	lat.
Intemperánz	lat.
Intempestiv	lat.
Intendánt	neulat.
Intendieren	lat.
Intensivum	lat.
Intention	lat.
Inter arma silent leges	lat.
Interdíkt	lat.
Interdiktion	lat.
Interésse	lat.
Interferénz	neulat.
Interieur	frz.
Interim	lat.
Interim fit aliquid	lat.
Interimístisch	neulat.
Interjektionen	lat.
Interkonfessionéll	neulat.
Interkostal	lat.
Interlinear	neulat.
Interlokut	lat.
Interludium	lat.
Interlunium	lat.
Intermediär	frz.
Intermezzo	ital.
Intermission	lat.
Intermittieren	lat.
Intermundien	lat.
Intérn	lat.
International	neulat.
Internieren	neulat.
Internodien	lat.
Intérnum	lat.
Internuntius	lat.
Interpellation	lat.
Inter pocula	lat.
Interpolieren	lat.
Interponieren	lat.
Interpretation	lat.
Interpunktion	lat.
Interregnum	lat.
Interrex	lat.
Interrogation	lat.
Interruption	lat.
Interséptum	lat.
Interstitium	lat.
Intertrigo	lat.
Interusurium	lat.
Interváll	lat.
Intervenieren	lat.
Interviewer	engl.
Inter vivos	lat.
Interzedieren	lat.
Interzeption	lat.
Interzession	lat.
Intestabel	lat.
Intestinum	lat.
Inthronisation	neulat.
Intim	lat.
Intimat	lat.
Intimus	lat.
Intitulation	neulat.
Intolerabel	lat.
Intonation	neulat.
Intrada	span.
Intramundan	lat.
Intramuran	lat.
Intransigént	lat.
Intransitiv	lat.
Intrige	frz.
Introduktion	lat.
Introitus	lat.
Intuition	lat.
Intus	lat.
Intussuszeption	neulat.
Inundation	lat.
Inunktion	lat.
In usum Delphini	lat.
Invagination	neulat.
Invalénz	lat.
Invariabel	neulat.
Invasion	lat.
Invécta et illata	lat.
Invektive	lat.
Invenit	lat.
Invention	lat.
Inventur	neulat.
In verba magistri schwören	lat.
Inversion	lat.
Invertebraten	neulat.
Invertieren	lat.
Investieren	lat.
Investigation	lat.
Investition	lat.
Investitur	lat.
Inveterieren	lat.
In vino veritas	lat.
Invinzibel	lat.
Inviolabel	lat.
Invisibel	lat.
Invitieren	lat.
Invoice	engl.
Invokation	lat.
Invokavit	lat.
Involukrum	lat.
Involution	lat.
Invulnerabel	lat.
Inzést	lat.
Inzidénz	lat.
Inzineration	neulat.
Inzision	lat.
Ipsissima verba	lat.
Irade	arab.
Irenik	grch.
Iridektomie	grch.
Iris	grch.
Irish bank	engl.
Irish stew	engl.
Ironbricks	engl.
Iron-clad	engl.
Ironie	grch.
Ironside	engl.
Iroquois	frz.
Irradiation	lat.
Irrational	lat.
Irrationéll	frz.
Irreformabel	lat.
Irregulär	neulat.
Irrelevánt	neulat.
Irreligiosität	lat.
Irreparabel	lat.
Irresistibel	neulat.
Irresolut	lat.
Irrespirabel	neulat.
Irresponsabel	neulat.
Irrevokabel	lat.
Irridieren	lat.
Irrigation	lat.
Irrigator	lat.
Irrision	lat.
Irritabel	lat.
Irrumpieren	lat.
Isaak	hebr.
Isagoge	grch.
Isametralen	grch.
Isanemonen	grch.
Isanomalen	grch.
Isbá	russ.
Ischurie	grch.
Is fecit cui prodest	lat.
Islâm	arab.
Ismael	hebr.
Isobaren	grch.
Isobathen	grch.
Isochásmen	grch.
Isochimenen	grch.
Isochionen	grch.
Isochromatisch	grch.
Isodynamie	grch.
Isogeothérmen	grch.
Isogon	grch.
Isohyeten	grch.
Isohypsen	grch.
Isoklinen	grch.
Isola	ital.
Isolieren	frz.
Isomer	grch.
Isometrie	grch.
Isomorph	grch.
Isonephen	grch.
Isoperimetrisch	grch.
Isopsephisch	grch.
Isorrhachien	grch.
Isotalantosen	grch.
Isotheren	grch.
Isothérmen	grch.
Isotrop	grch.
Ispan	ungar.
Ispráwnik	russ.
Israel	hebr.
Istesso tempo	ital.
Isthmus	grch.
Iswóschtschik	russ.
Italia farà de sè	ital.
Italia irredénta	ital.
Italique	frz.
Item	lat.
Iteration	lat.
Iterativum	lat.
Itinerarium	lat.
Jabot	frz.
Jachin und Boas	hebr.
Jack	engl.
Jacta est alea	lat.
Jago	span.
Jakob	hebr.
Jakonett	engl.
Jalon	frz.
Jalousie	frz.
Jam	engl.
James	engl.
Jan	niederländ.
Jane	engl.
János	ungar.
Januar	lat.
Jardin	frz.
Jardinière	frz.
Jargon	frz.
Jättestuër	dän.
Jayme	span.
Jean	frz.
Jeannette	frz.
Jean Potage	frz.
Jehu	hebr.
Jeni	türk.
Jeréj	russ.
Jesreel	hebr.
Jeton	frz.
Jeunesse dorée	frz.
Jeux floraux	frz.
Jig	engl.
Joaillerie	frz.
João	portug.
Jobber	engl.
Joël	hebr.
John	engl.
John Bull	engl.
Jongleurs	frz.
Jonquille	frz.
Jour fixe	frz.
Journal	frz.
Journal	frz.
Jovial	lat.
Joyeuse entrée	frz.
Juan	span.
Jubilate	lat.
Jubiläum	lat.
Jubilieren	lat.
Jubis	frz.
Judex	lat.
Judicium	lat.
Judika	lat.
Judikat	lat.
Judikatur	neulat.
Judiz	lat.
Jugum	lat.
Jul	altnord.
Julap	arab.
Julienne	frz.
Jumpers	engl.
Jungle	engl.
Junimea	rumän.
Junior	lat.
Junktur	lat.
Junta	span.
Jupe	frz.
Jupon	frz.
Jura	lat.
Jure	lat.
Jurisconsúltus	lat.
Jurisdiktion	lat.
Jurisprudénz	lat.
Juríst	mittellat.
Juror	engl.
Jurte	türk.
Jury	engl.
Jus	lat.
Jus	frz.
Justemilieu	frz.
Justice of the Peace	engl.
Justieren	neulat.
Justifikation	lat.
Justitia	lat.
Justitiarius	neulat.
Justitium	lat.
Justiz	lat.
Justorium	neulat.
Juvenil	lat.
Juxta	lat.
Kaaba	arab.
Kabale	frz.
Kabane	frz.
Kabbala	hebr.
Kabine	frz.
Kabotage	frz.
Kabriolétt	frz.
Kachéktik	grch.
Kachexie	grch.
Kadaver	lat.
Kadénz	ital.
Kadettieren	frz.
Kadi	arab.
Kaftan	türk.
Kaimakâm	arab.
Kaïmeh	arab.
Kainozoisch	grch.
Kajolieren	frz.
Kakodämon	grch.
Kakologie	grch.
Kakophonie	grch.
Kalade	frz.
Kalamität	lat.
Kaleidoskop	grch.
Kalette	ital.
Kalieren	ital.
Kalif	arab.
Kaliologie	grch.
Kalkánt	lat.
Kalkül	frz.
Kallidität	lat.
Kalligraph	grch.
Kalliope	grch.
Kallipygos	grch.
Kallirrhoe	grch.
Kallös	lat.
Kalmieren	frz.
Kalobiotik	grch.
Kalokagathie	grch.
Kaloreszénz	lat.
Kalorie	frz.
Kalorifere	frz.
Kalorik	lat.
Kalospinthechromokrene	grch.
Kalotte	frz.
Kalpak	türk.
Kalumnie	lat.
Kalypso	grch.
Kamala	bengal.
Kamarilla	span.
Kameen	ital.
Kameriere	ital.
Kamin	lat.
Kamisade	frz.
Kamisol	frz.
Kampagne	frz.
Kampana	ital.
Kampanile	ital.
Kampieren	frz.
Kandelaber	lat.
Kandieren	frz.
Kanephoren	grch.
Kannelieren	frz.
Kanon	grch.
Kanonik	grch.
Kanter	engl.
Kantilene	ital.
Kantine	ital.
Kanton	frz.
Kantonade	frz.
Kantonière	ital.
Kantonnement	frz.
Kántor	lat.
Kanüle	frz.
Kanzellariat	neulat.
Kanzellation	lat.
Kanzonetta	ital.
Kapabel	frz.
Kapazität	lat.
Kapieren	lat.
Kapillaren	lat.
Kapillarität	lat.
Kapital	lat.
Kapitale	lat.
Kapitän	mittellat.
Kapitularien	lat.
Kapitulation	neulat.
Kaponniere	frz.
Kapplaken	holländ.
Kaprice	frz.
Kapriole	ital.
Kaptatorisch	lat.
Kaption	lat.
Kaptivation	lat.
Kaptur	lat.
Kapusta	russ.
Karakolieren	frz.
Karákul	tatar.
Karambolage	frz.
Karasu	türk.
Karbatsche	türk.
Karbonade	frz.
Karbonari	ital.
Karchedon	grch.
Kardia	grch.
Kardiograph	grch.
Kardioide	grch.
Karditis	grch.
Karénz	lat.
Karessieren	frz.
Karieren	lat.
Kariert	frz.
Karies	lat.
Kariös	lat.
Karkajou	frz.
Karkasse	frz.
Karnation	lat.
Karneval	ital.
Karnivoren	lat.
Karosse	frz.
Karosserie	frz.
Karotis	grch.
Karotte	frz.
Karphologie	grch.
Karpolithen	grch.
Karrete	span.
Karriere	frz.
Kartieren	frz.
Kartisane	frz.
Kartográmm	grch.
Kartographie	grch.
Kartometer	grch.
Kartometrie	grch.
Karunkel	lat.
Karyatiden	grch.
Karyópse	grch.
Karzer	lat.
Kaschieren	frz.
Kasematten	span.
Kasino	ital.
Kaskade	ital.
Kaskarilla	span.
Kassation	frz.
Kassette	frz.
Kassîde	arab.
Kassieren	frz.
Kassinett	engl.
Kassolette	frz.
Kastagnetten	ital.
Kastellan	lat.
Kastigation	lat.
Kastration	lat.
Kastrieren	lat.
Kasuístik	lat.
Katabóthren	neugrch.
Katachrese	grch.
Katafálk	ital.
Kataklysma	grch.
Katalékten	grch.
Kataléktisch	grch.
Katalepsie	grch.
Katalexis	grch.
Katalog	grch.
Katalyse	grch.
Katamenien	grch.
Kataphrákt	grch.
Kataplásma	grch.
Kataplexie	grch.
Katapulte	lat.
Katarákt	grch.
Katárrh	grch.
Katastrophe	grch.
Katatonie	grch.
Katatypie	grch.
Katechese	grch.
Katechismus	grch.
Katechumenen	grch.
Kategorie	grch.
Katharer	grch.
Kathársis	grch.
Katheder	grch.
Katheten	grch.
Katheter	grch.
Kathetometer	grch.
Kathode	grch.
Katholikos	grch.
Katóptrik	grch.
Kaulom	neulat.
Kausativ	lat.
Kaustisch	grch.
Kautel	lat.
Kaution	lat.
Kavalier	frz.
Kavalkade	frz.
Kavatine	ital.
Kavént	lat.
Kavérne	lat.
Kavieren	lat.
Keg	engl.
Keloid	grch.
Kelotomie	grch.
Kennel	engl.
Kenotaphion	grch.
Kentauren	grch.
Keos	altgrch.
Kephalalgie	grch.
Kephalothorax	grch.
Keramik	grch.
Keratitis	grch.
Keratoid	grch.
Keratolith	grch.
Keratom	grch.
Keratonosen	grch.
Keratoplástik	grch.
Keratoskop	grch.
Kerberos	grch.
Keren	grch.
Kermes	arab.
Kerykeion	grch.
Kerýktik	grch.
Khaki	ind.
Kid	engl.
Kilar	neugrch.
Kiln	engl.
Kilograph	grch.
Kinäde	grch.
Kinästhesie	grch.
Kindschal	türk.
Kinematik	grch.
Kinematograph	grch.
Kinetik	grch.
Kinetoskop	grch.
King	engl.
King's Bench	engl.
Kiósk	türk.
Kismet	arab.
Kithara	grch.
Kjökkenmöddinger	dän.
Klarieren	lat.
Klassizismus	neulat.
Klassizität	neulat.
Klausur	lat.
Kleistogamie	grch.
Klephthen	neugrch.
Klepsydra	grch.
Kleptomanie	grch.
Klerus	grch.
Klima	grch.
Klimakterisch	grch.
Klimatographie	grch.
Klimax	grch.
Klinik	grch.
Klinometer	grch.
Klinoskop	grch.
Klisiometer	grch.
Klitoris	grch.
Kloasma	grch.
Klonisch	grch.
Klysma	grch.
Klysopompe	frz.
Kmet	slaw.
Knight	engl.
Knowledge is power	engl.
Koadjutor	lat.
Koalieren	lat.
Koaptation	lat.
Koätan	lat.
Koëdukation	lat.
Koëffizient	neulat.
Koërzibel	neulat.
Koëxisténz	lat.
Kogitation	lat.
Kognaten	lat.
Kognition	lat.
Kohabitation	lat.
Kohärénz	lat.
Kohäsion	lat.
Kohäsiv	lat.
Koheleth	hebr.
Kohibieren	lat.
Kohobation	frz.
Kohortation	lat.
Koilanaglyph	grch.
Koimeterion	grch.
Koinobion	grch.
Koïnzidént	neulat.
Koi-su	türk.
Koje	niederd.
Kokarde	frz.
Kokkus	grch.
Kokon	frz.
Kokotte	frz.
Koláptik	grch.
Kolatur	lat.
Kolieren	lat.
Kolik	grch.
Kollateral	lat.
Kollation	lat.
Kollatur	lat.
Kollaudation	lat.
Kollegiaten	lat.
Kollegium	lat.
Kollékte	lat.
Kollekteur	frz.
Kollektion	lat.
Kollenchym	grch.
Kolli	ital.
Kollidieren	lat.
Kollier	frz.
Kollimation	lat.
Kolliquation	lat.
Kollision	lat.
Kollo	ital.
Kollokation	lat.
Kolloquium	lat.
Kollotypie	grch.
Kollusion	lat.
Kollutorium	lat.
Kólokol	russ.
Kolombine	ital.
Kolon	grch.
Kolonat	lat.
Kolonisation	neulat.
Kolonnade	frz.
Kolonne	frz.
Kolophon	grch.
Koloratur	ital.
Kolorieren	lat.
Kolorit	lat.
Kolóß	grch.
Kolossal	frz.
Kolostrum	lat.
Kolpeurynter	grch.
Kolpitis	grch.
Kolporteur	frz.
Kolumbarium	lat.
Kolumne	lat.
Koluren	grch.
Koma	grch.
Kombattanten	frz.
Kombination	lat.
Kombinieren	lat.
Kombüse	niederländ.
Kombustibel	lat.
Komestibel	lat.
Kometen	grch.
Komfort	engl.
Komik	grch.
Komma	grch.
Kommandánt	frz.
Kommandement	frz.
Kommanderie	frz.
Kommandeur	frz.
Kommandieren	frz.
Kommandite	frz.
Kommando	ital.
Kommassation	neulat.
Kommensalismus	neulat.
Kommigratorismus	neulat.
Kommiß	lat.
Kommissar	lat.
Kommission	lat.
Kommissionär	frz.
Kommissorium	lat.
Kommissur	lat.
Kommittént	lat.
Kommode	frz.
Kommodore	engl.
Kommorienten	lat.
Kommotion	lat.
Kommun	lat.
Kommunal	lat.
Kommunikánt	lat.
Kommunikation	lat.
Kommunion	lat.
Kommunismus	neulat.
Kommutation	lat.
Kommutator	neulat.
Komödie	grch.
Kompagnon	frz.
Kompákt	lat.
Kompaktat	mittellat.
Komparabel	lat.
Komparation	lat.
Komparator	lat.
Komparse	ital.
Kompaß	ital.
Kompatibel	lat.
Kompatriot	frz.
Kompaziszieren	lat.
Kompellieren	lat.
Kompendium	lat.
Kompensation	lat.
Kompensieren	lat.
Kompetént	lat.
Kompeténz	lat.
Kompilation	lat.
Komplanation	lat.
Komplektieren	lat.
Komplemént	lat.
Kompletorium	lat.
Komplice	frz.
Komplikationen	lat.
Komplimént	frz.
Komplizieren	lat.
Komplótt	frz.
Komponénte	lat.
Komponieren	lat.
Komposition	lat.
Kompositum	lat.
Kompótt	frz.
Kompréß	lat.
Kompresse	frz.
Kompressibilität	neulat.
Kompression	lat.
Kompréssor	lat.
Kompressorium	neulat.
Komprimieren	lat.
Kompromíß	lat.
Komptabel	frz.
Komputabel	lat.
Konák	türk.
Konchoide	grch.
Konchylien	grch.
Kondemnation	lat.
Kondensation	lat.
Kondensator	neulat.
Kondensieren	lat.
Kondimént	lat.
Kondition	lat.
Kondolénz	lat.
Kondominat	neulat.
Konduite	frz.
Kondúkt	lat.
Kondukteur	frz.
Kondúktor	lat.
Kondylom	grch.
Konfékt	lat.
Konfektion	lat.
Konferénz	lat.
Konferieren	lat.
Konféß	lat.
Konfession	lat.
Konféssor	lat.
Konfidénz	lat.
Konfiguration	lat.
Konfination	mittellat.
Konfinien	lat.
Konfirmation	lat.
Konfiserie	frz.
Konfiskation	lat.
Konfitént	lat.
Konflagration	lat.
Konflíkt	lat.
Konföderation	lat.
Konfórm	lat.
Konfrontation	mittellat.
Konfundieren	lat.
Konfutation	lat.
Kongelation	lat.
Kongenial	neulat.
Kongestion	lat.
Konglomerat	lat.
Konglutination	lat.
Kongregation	lat.
Kongréß	lat.
Kongruént	lat.
Konisch	grch.
Konjektaneen	lat.
Konjektur	lat.
Konjugal	lat.
Konjugation	lat.
Konjunktion	lat.
Konjunktiv	lat.
Konjunktur	lat.
Konjuration	lat.
Konkav	lat.
Konklave	lat.
Konkludieren	lat.
Konkomitánz	lat.
Konkordánz	lat.
Konkordat	lat.
Konkremént	lat.
Konkret	lat.
Konkretion	lat.
Konkubinat	lat.
Konkurrént	lat.
Konkúrs	lat.
Konkussion	lat.
Konnéx	lat.
Konnivieren	lat.
Konnubial	lat.
Konoid	grch.
Konquistadoren	span.
Konrektor	neulat.
Konsanguinität	lat.
Konsekration	lat.
Konsekutiv	neulat.
Konsentieren	lat.
Konsequént	lat.
Konservativ	lat.
Konservator	lat.
Konservatorium	neulat.
Konserven	frz.
Konservieren	lat.
Konsiderabel	lat.
Konsignation	lat.
Konsignieren	lat.
Konsistént	lat.
Konsistorium	lat.
Konskription	lat.
Konsole	frz.
Konsonánt	lat.
Konsonánz	lat.
Konsorten	lat.
Konsortium	lat.
Konspergieren	lat.
Konspiration	lat.
Konstánt	lat.
Konstatieren	frz.
Konstellation	lat.
Konsternation	lat.
Konstipation	lat.
Konstituieren	lat.
Konstitution	lat.
Konstitutionéll	frz.
Konstitutiv	lat.
Konstriktion	lat.
Konstruieren	lat.
Konsul	lat.
Konsulént	lat.
Konsultation	lat.
Konsum	ital.
Konsumtibilien	neulat.
Konsumtion	lat.
Kontagion	lat.
Kontákt	lat.
Kontamination	lat.
Kontemplation	lat.
Kontemporär	neulat.
Kontentieren	frz.
Konterapprochen	frz.
Konterbande	frz.
Kontereskarpe	frz.
Kontergarde	frz.
Kontermandieren	frz.
Kontermarke	frz.
Kontermine	frz.
Konterorder	frz.
Konterpartie	frz.
Kontestabel	lat.
Kontéxt	lat.
Konti	ital.
Kontignation	lat.
Kontinent	lat.
Kontinental	neulat.
Kontingént	lat.
Kontinuation	lat.
Kontinuität	lat.
Kontorsion	lat.
Kontra	lat.
Kontradiktion	lat.
Kontrahieren	lat.
Kontraindikation	lat.
Kontrákt	lat.
Kontrákt	lat.
Konträr	frz.
Kontrasignatur	neulat.
Kontrást	frz.
Kontraveniént	lat.
Kontribuieren	lat.
Kontrition	lat.
Kontrolle	frz.
Kontrovérs	lat.
Kontusion	lat.
Konus	lat.
Konvaleszénz	lat.
Konveniénz	lat.
Konvént	lat.
Konventikel	lat.
Konvention	lat.
Konventualen	neulat.
Konvergént	neulat.
Konversation	frz.
Konversieren	lat.
Konversion	lat.
Konvérter	engl.
Konvertieren	lat.
Konvéx	lat.
Konviktion	lat.
Konvinzieren	lat.
Konvivium	lat.
Konvokation	lat.
Konvolut	lat.
Konvulsion	lat.
Konzedieren	lat.
Konzentration	frz.
Konzépt	lat.
Konzért	lat.
Konzession	lat.
Konziliation	lat.
Konzínn	lat.
Konzis	lat.
Kooperation	lat.
Kooptieren	lat.
Koordinaten	neulat.
Koordination	neulat.
Kopialien	neulat.
Kopieren	frz.
Kopiös	lat.
Kopíst	frz.
Kopremese	grch.
Koprolithen	grch.
Koprophagie	grch.
Koprostase	grch.
Kopula	lat.
Kopulation	lat.
Kordial	frz.
Kordieren	frz.
Kordon	frz.
Korektasie	grch.
Korfú	ital.
Kormophyten	grch.
Korporation	lat.
Korps	frz.
Korpulént	lat.
Korpus	lat.
Korrasion	lat.
Korreal	lat.
Korreferént	lat.
Korrékt	lat.
Korrelat	neulat.
Korrepetieren	neulat.
Korrespondént	neulat.
Korrespondénz	neulat.
Korridor	frz.
Korrigieren	lat.
Korroboration	lat.
Korrodieren	lat.
Korrumpieren	lat.
Korvette	frz.
Koryza	grch.
Kosmetik	grch.
Kosmisch	grch.
Kosmogonie	grch.
Kosmographie	grch.
Kosmologie	grch.
Kosmopolit	grch.
Kosmos	grch.
Kosmotheïsmus	grch.
Kotangénte	lat.
Koterie	frz.
Kothúrn	grch.
Kotierung	frz.
Kotillon	frz.
Kotisation	frz.
Kotoyieren	frz.
Kotyledonen	grch.
Kral	slaw.
Kranioklást	grch.
Kraniologie	grch.
Kraniometrie	grch.
Krapüle	frz.
Krater	grch.
Kreation	lat.
Kredénzen	ital.
Kredibilität	neulat.
Kredit	lat.
Kreditor	lat.
Kredulität	lat.
Krëieren	lat.
Kremation	lat.
Kren	slaw.
Krenelieren	frz.
Kreophag	grch.
Krepieren	lat.
Krepitation	lat.
Krepon	frz.
Kreszénz	lat.
Krethi und Plethi	hebr.
Kretscham	slaw.
Kriminal	lat.
Kriminalität	neulat.
Kriminéll	frz.
Krisis	grch.
Krispation	lat.
Kristalle	grch.
Kriterium	grch.
Kritik	grch.
Krokydismus	grch.
Kromlech	kelt.
Krotalon	grch.
Krudität	lat.
Krustieren	lat.
Kryokonit	grch.
Kryolith	grch.
Kryophor	grch.
Kryoskopie	grch.
Kryostaz	grch.
Krypta	grch.
Kryptogamen	grch.
Kryptograph	grch.
Kryptomer	grch.
Kryptonym	grch.
Kryptophon	grch.
Kryptorchismus	grch.
Kryptoskop	grch.
Kubatur	neulat.
Kubus	lat.
Kula	türk.
Külasse	frz.
Kulinarisch	lat.
Kulmination	lat.
Kulpos	lat.
Kultivator	neulat.
Kultivieren	neulat.
Kultur	lat.
Kum	türk.
Kumulation	lat.
Kumulus	lat.
Kuneïfórm	lat.
Künette	frz.
Küpe	niederd.
Kupéz	russ.
Kupidität	lat.
Kupido	lat.
Kupieren	frz.
Kurabel	lat.
Kuránd	lat.
Kuránt	frz.
Kuratel	lat.
Kürette	frz.
Kurialien	lat.
Kurieren	lat.
Kurios	lat.
Kurrénde	lat.
Kursorisch	lat.
Kurve	lat.
Kustos	lat.
Küvette	frz.
Kymographion	grch.
Kynologie	grch.
Kynoskephalä	grch.
Kyphose	grch.
Kyrie eléïson	grch.
Kystoskopie	grch.
Labial	lat.
Labil	lat.
Labiodental	lat.
Lablab	arab.
Laboratorium	lat.
Laborieren	lat.
La bourse ou la vie	frz.
Labyrínth	grch.
Lac	lat.
Lac	frz.
Lac-dye	engl.
Lace	engl.
Lacet	frz.
Lâche	frz.
Lacis	frz.
Lac-lake	engl.
Lacrimae Christi	lat.
Lacus	lat.
Lädieren	lat.
Lady	engl.
Lagena	lat.
Lagunen	ital.
Laird	schott.
Laisser faire	frz.
Laktation	neulat.
Lalla Rookh	engl.
Lama	tibet.
Lambrequin	frz.
Lambris	frz.
Lamelle	lat.
Lamentabel	lat.
Lampadarium	lat.
Lampion	frz.
Lana	lat.
Lancea	lat.
Lancier	frz.
Lancieren	frz.
Landlord	engl.
Langettieren	frz.
Languénte	ital.
Lanista	lat.
Lansquenet	frz.
Lanugo	lat.
Laparotomie	grch.
Lapins	frz.
Lapis	lat.
Lappets	engl.
Lapsi	lat.
Lapsus	lat.
Larghetto	ital.
Largo	ital.
Larmoyant	frz.
Larve	lat.
Larviert	frz.
Laryngitis	grch.
Larynx	grch.
Larynxödem	grch.
Läsion	lat.
Lasur	arab.
Lasziv	lat.
Lätare	lat.
Latént	lat.
Laténz	lat.
Lateral	lat.
Laterieren	lat.
Laterna magica	lat.
Laterne	lat.
Latifolisch	lat.
Latifundium	lat.
Latitude	frz.
Latitudinal	neulat.
Latitudinarier	neulat.
Latomien	grch.
Latrie	grch.
Latrine	lat.
Latrocinium	lat.
Latus	lat.
Laudabel	lat.
Laudanum	lat.
Laudemium	lat.
Laudes	lat.
Laudieren	lat.
Laus	lat.
Lava	neapolit.
Lavabo	lat.
Lavacrum	lat.
Lavation	lat.
Lavement	frz.
Lavieren	frz.
Lavoir	frz.
Lawn-Tennis	engl.
Lawyer	engl.
Lax	lat.
Laxieren	lat.
Lazerieren	lat.
Lazzi	ital.
Leader	engl.
Leaguer	engl.
Lecture	engl.
Legal	lat.
Legat	lat.
Legato	ital.
Lege artis	lat.
Leges barbarorum	lat.
Legger	holländ.
Leggiere	ital.
Legio fulminatrix	lat.
Legion	lat.
Legionär	frz.
Légion d'honneur	frz.
Legis actiones	lat.
Legislation	lat.
Legismus	neulat.
Legitim	lat.
Legitimation	neulat.
Legitimieren	neulat.
Lègre	frz.
Legumen	lat.
Leisten	jurist.
Leiturgie	grch.
Lektion	lat.
Lektor	lat.
Lektüre	frz.
Lemma	grch.
Lendemain	frz.
Lenis	lat.
Lentikular	lat.
Lentitis	lat.
Lento	ital.
Leontiasis	grch.
Lepra	grch.
Lestage	frz.
Lesto	ital.
Letal	lat.
Lethargie	grch.
Lethe	grch.
Lettera	ital.
Letter-box	engl.
Lettern	lat.
Lettre	frz.
Lettres de cachet	frz.
Leukäthiopie	grch.
Leukom	grch.
Leukopathie	grch.
Leukoplakie	grch.
Leukorrhöe	grch.
Leukozyten	grch.
Leukozythämie	grch.
Leukozytose	grch.
Levade	frz.
Levante	ital.
Levellers	engl.
Lever	frz.
Lexikon	grch.
Liaison	frz.
Lias	engl.
Libation	lat.
Libéll	lat.
Libella	lat.
Libelle	lat.
Liberal	lat.
Libertät	lat.
Libertin	frz.
Liberum arbitrium	lat.
Liberum Veto	lat.
Librarius	lat.
Libration	lat.
Libretto	ital.
License	engl.
Licentia	lat.
Licet	lat.
Lichenologie	grch.
Lidi	ital.
Lido	ital.
Lieutenant Governor	engl.
Lift	engl.
Ligade	frz.
Ligamént	lat.
Ligato	ital.
Ligatur	lat.
Ligature	frz.
Ligieren	lat.
Ligue	frz.
Liieren	frz.
Li-kin	chines.
Limakologie	grch.
Limbus	lat.
Limes	lat.
Limestone	engl.
Limitation	lat.
Limited	engl.
Limitum	lat.
Limnigraph	grch.
Limnimetrie	grch.
Limnologie	grch.
Limnoplankton	grch.
Limonage	frz.
Limpid	lat.
Linamént	lat.
Line	engl.
Linea	lat.
Lineaménte	lat.
Linear	lat.
Lingerie	frz.
Lingua	lat.
Lingual	lat.
Linguíst	lat.
Linimént	lat.
Linon	frz.
Linophanie	grch.
Linsey-woolsey	engl.
Lint	engl.
Lion	frz.
Lipämie	grch.
Lipom	grch.
Lipurie	grch.
Liquefaktion	lat.
Liquet	lat.
Liqueur	frz.
Liquid	lat.
Liquidae	lat.
Liquidation	lat.
Liquid gas	engl.
Liquor	lat.
Lira	ital.
Lisseuse	frz.
Litanei	grch.
Lit de justice	frz.
Lite pendente	lat.
Litera	lat.
Literarisch	lat.
Literat	lat.
Literatur	lat.
Litewka	poln.
Lithargyrum	lat.
Lithiasis	grch.
Lithobolen	grch.
Lithofrakteur	frz.
Lithographie	grch.
Litholapaxie	grch.
Lithologie	grch.
Litholyse	grch.
Lithopädion	grch.
Lithophanie	grch.
Lithosphäre	grch.
Lithúrgik	grch.
Litigánt	lat.
Litisdenunziation	lat.
Litorale	lat.
Litre	frz.
Lituus	lat.
Livid	lat.
Livre	frz.
Livree	frz.
Lizénz	lat.
Lizitation	lat.
Llanos	span.
Loa	span.
Loafers	engl.
Lobär	lat.
Loch	gäl.
Lochien	grch.
Lochos	grch.
Loci	lat.
Lock-out	engl.
Loco	lat.
Locus	lat.
Loge	frz.
Logement	frz.
Loggia	ital.
Logieren	frz.
Logik	grch.
Logis	frz.
Logisch	grch.
Logismographie	grch.
Logísten	grch.
Logographen	grch.
Logogriph	grch.
Logoneurosen	grch.
Lógos	grch.
Logothet	grch.
Logotypen	grch.
Lokal	lat.
Lokalien	lat.
Lokalisieren	lat.
Lokatar	lat.
Lokation	lat.
Lokativ	lat.
Lokator	lat.
Lokomobile	lat.
Lokomotive	lat.
Lokotenént	lat.
Lokupletieren	lat.
Longe	frz.
Longieren	frz.
Longimanus	lat.
Longitudinal	lat.
Long Primer	engl.
Longuette	frz.
Lordosis	grch.
Lordship	engl.
Lorgnette	frz.
Lorraine	frz.
Lot	engl.
Lotion	lat.
Lotophagen	grch.
Lotterie	frz.
Lotto	ital.
Louis	frz.
Louisdor	frz.
Loure	frz.
Low Church	engl.
Lowry	engl.
Loyal	frz.
Lozieren	lat.
Lucina	lat.
Luës	lat.
Lugubre	ital.
Lugubrität	lat.
Lukrativ	lat.
Lukubration	lat.
Lumachello	ital.
Lumbago	lat.
Lumen	lat.
Luminös	lat.
Luna	lat.
Lunarium	neulat.
Lunatisch	lat.
Lünette	frz.
Lungenatelektase	grch.
Lunula	lat.
Lunulae Hippocratis	lat.
Lupus	lat.
Lustration	lat.
Lustre	frz.
Lustrieren	lat.
Lüstrieren	frz.
Lustrum	lat.
Lutamént	lat.
Lutieren	lat.
Lutum	lat.
Lux	lat.
Luxation	lat.
Luxurieren	neulat.
Luxus	lat.
Luzid	lat.
Luzifer	lat.
Lycée	frz.
Lykanthrop	grch.
Lymphadenitis	grch.
Lymphatisch	lat.
Lymphe	lat.
Lyra	grch.
Lysis	grch.
Maat	niederländ.
Maatschappij	niederländ.
Mace	engl.
Machination	lat.
Machsor	hebr.
Macis	frz.
Maçon	frz.
Macte!	lat.
Macula	lat.
Madapolam	ostind.
Made in Germany	engl.
Madeleine	frz.
Madelonetten	frz.
Madonna	ital.
Maduro	span.
Maëstà	ital.
Maëstoso	ital.
Maëstro	ital.
Mäeutik	grch.
Magasinage	frz.
Maggiore	ital.
Magíster	lat.
Magisterium	lat.
Magistral	lat.
Magistrale	lat.
Magistratus	lat.
Magma	grch.
Magna Charta	lat.
Magna mater	lat.
Magnaten	neulat.
Magnet	grch.
Magnetograph	grch.
Magnetometer	grch.
Magnetopath	grch.
Magnetoskop	grch.
Magnetotherapie	grch.
Magnifikat	lat.
Magnifizénz	lat.
Magnus	lat.
Maiden	engl.
Maiden speech	engl.
Mail	engl.
Mail	frz.
Mail-coach	engl.
Maillechort	frz.
Maillon	frz.
Main	frz.
Maintenieren	frz.
Maire	frz.
Maison	frz.
Maître	frz.
Maitresse	frz.
Majorat	mittellat.
Major Domus	lat.
Majorénn	mittellat.
Majorität	lat.
Majúskeln	lat.
Makâme	arab.
Makarísmen	grch.
Makrobiotik	grch.
Makrokephalie	grch.
Makrokósmos	grch.
Makromer	grch.
Makrosomie	grch.
Makrozyten	grch.
Makulatur	lat.
Malade	frz.
Mala fides	lat.
Malakozoen	grch.
Mal-à-propos	frz.
Mal de Caderas	span.
Mal de los pintos	span.
Malefikánt	lat.
Malice	frz.
Malié	arab.
Malkontént	frz.
Malle	frz.
Malleolus	lat.
Malleus	lat.
Malmsey	engl.
Malorossíja	russ.
Malosól	russ.
Mal pintado	span.
Malpropre	frz.
Malträtieren	frz.
Malversation	frz.
Malvoisie	frz.
Mamelucken	arab.
Mamelucos	span.
Mamma	lat.
Mammalia	lat.
Manager	engl.
Mancando	ital.
Mancipatio	lat.
Mandat	lat.
Mandora	ital.
Mandrin	frz.
Mangal	türk.
Manganeut	grch.
Manie	grch.
Manier	frz.
Manifést	mittellat.
Manifestation	lat.
Manille	span.
Manipulation	lat.
Manko	ital.
Manometer	grch.
Manon	frz.
Manor	engl.
Manöver	frz.
Manquement	frz.
Manschette	frz.
Mantelet	frz.
Mantilla	span.
Mantisse	lat.
Manual	lat.
Manubien	lat.
Manuduktion	lat.
Manufaktur	lat.
Manumission	lat.
Manu propria	lat.
Manus	lat.
Manuskrípt	lat.
Manustupration	lat.
Mappemonde	frz.
Marásmus	lat.
Marchand	frz.
Marcia	ital.
Mardelle	frz.
Mardi	frz.
Mare	lat.
Maréchal	frz.
Marée	frz.
Marge	frz.
Margelle	frz.
Marginalien	neulat.
Margot	frz.
Marguerite	frz.
Mariage	frz.
Marialatrie	grch.
Marine	frz.
Marinieren	frz.
Marionette	frz.
Maritim	lat.
Markieren	frz.
Marmotte	frz.
Marode	frz.
Maroquin	frz.
Marotte	frz.
Marques	span.
Marqueß	engl.
Marqueterie	frz.
Marqueur	frz.
Marquis	frz.
Marquise	frz.
Martha	aram.
Martialis	lat.
Martialisch	lat.
Märtyrer	grch.
Mascaret	frz.
Mâschallâh	arab.
Maschinerie	frz.
Maschrik	arab.
Masematten	jüd.
Maskaríll	span.
Maskulinum	lat.
Máslás	ungar.
Másleniza	russ.
Mason	engl.
Massage	frz.
Masseter	grch.
Masseur	frz.
Massicot	frz.
Massieren	frz.
Massiv	frz.
Mastaba	arab.
Master	engl.
Mastitis	grch.
Masút	russ.
Matador	span.
Matamoros	span.
Match	engl.
Mater	lat.
Mater dolorosa	lat.
Material	lat.
Materialismus	lat.
Materialität	neulat.
Materialiter	lat.
Materiation	lat.
Materie	lat.
Materiéll	frz.
Mater magna	lat.
Matérn	lat.
Mathema	grch.
Mathematik	grch.
Mathesis	grch.
Matinee	frz.
Matjeshering	niederländ.
Matrikel	lat.
Matrimonial	lat.
Matrone	lat.
Matt	pers.
Matureszieren	lat.
Maturieren	lat.
Maturität	lat.
Mátuschka	russ.
Matutinal	lat.
Mauchamps	frz.
Maun	engl.
Maussaderie	frz.
Mauvais sujet	frz.
Maxilla	lat.
Maximal	lat.
Maxime	frz.
Maximum	lat.
Mayonnaise	frz.
Mazagran	frz.
Mazzocchio	ital.
Mazzoth	hebr.
Meat	engl.
Mechanik	grch.
Mechanismus	grch.
Mechanotherapie	grch.
Mechanurgie	grch.
Mechulle	hebr.
Meconium	lat.
Medaille	frz.
Medaillon	frz.
Mediae	lat.
Medial	lat.
Median	lat.
Mediánte	ital.
Mediastinum	lat.
Mediat	neulat.
Mediateur	frz.
Medicaménta	lat.
Medicus	lat.
Medien	lat.
Medikamént	lat.
Medîna	arab.
Medio	lat.
Mediokrität	lat.
Medisance	frz.
Meditation	lat.
Mediterran	lat.
Medium	lat.
Medizin	lat.
Medizinaltaxe	lat.
Medizinieren	lat.
Medrese	arab.
Medschlis	arab.
Medúlla	lat.
Meeting	engl.
Mega-	grch.
Megalopsie	grch.
Megaphon	grch.
Megaskop	grch.
Mekonium	grch.
Melanämie	grch.
Melancholie	grch.
Mélange	frz.
Melanom	grch.
Melanose	grch.
Melanoskop	grch.
Melanurie	grch.
Melasma	grch.
Melasse	frz.
Melchisedek	hebr.
Melieren	frz.
Melioration	lat.
Melisma	grch.
Melitämie	grch.
Meliturie	grch.
Melodie	grch.
Melodrama	grch.
Melophon	grch.
Melyphon	grch.
Member of Parliament	engl.
Meménto	lat.
Memoire	frz.
Memoiren	frz.
Memorabel	lat.
Memorándum	lat.
Memorieren	lat.
Menage	frz.
Menagerie	frz.
Menahem	hebr.
Menäon	grch.
Mendikánten	lat.
Menestrels	frz.
Menéstriers	frz.
Menhirs	kelt.
Meningitis	grch.
Meninx	grch.
Meniskus	grch.
Meno	ital.
Menologium	grch.
Menopause	grch.
Menostase	grch.
Menses	lat.
Menstrual	lat.
Menstruum	lat.
Mensual	lat.
Mensur	lat.
Mensurabel	lat.
Mental	lat.
Mente captus	lat.
Mentone	ital.
Menuiserie	frz.
Menus plaisirs	frz.
Mercurialia	lat.
Mercurius	lat.
Meridian	lat.
Meridies	lat.
Merino	span.
Meristem	grch.
Meritorisch	lat.
Meritum	lat.
Merkantilisch	neulat.
Merlette	frz.
Merlúschki	russ.
Merveilleuses	frz.
Meryzismus	grch.
Mesalliance	frz.
Mesenterium	grch.
Mesoblást	grch.
Mesodérm	grch.
Mesogastrium	grch.
Mesokephalie	grch.
Mesolithisch	grch.
Mesomphalium	grch.
Mesopentekóste	grch.
Mesophýll	grch.
Mesopotamien	grch.
Mesostylon	grch.
Mesozoisch	grch.
Mesquinerie	frz.
Mess	engl.
Messa di voce	ital.
Messieurs	frz.
Messrs.	engl.
Mestizen	span.
Mesure	frz.
Mesusa	hebr.
Metabasis	grch.
Metachromatypie	grch.
Metachronismus	grch.
Metagenesis	grch.
Metagnostik	grch.
Métairie	frz.
Metakritik	grch.
Metalepsie	grch.
Metalle	grch.
Metalliques	frz.
Metallochromie	grch.
Metallographie	grch.
Metalloskopie	grch.
Metallotherapie	grch.
Metallurgie	grch.
Metamer	grch.
Metameren	grch.
Metamorphopsie	grch.
Metamorphose	grch.
Metamorphosieren	grch.
Metaphrase	grch.
Metaphysik	grch.
Metastase	grch.
Metatarsus	grch.
Metathesis	grch.
Métaux forgés	frz.
Metempsychose	grch.
Metemptose	grch.
Meteore	grch.
Meteorismus	grch.
Meteorograph	grch.
Meteorolithen	grch.
Meteorolog	grch.
Meteorologie	grch.
Methode	grch.
Methodik	grch.
Metier	frz.
Metonomasie	grch.
Metonymie	grch.
Metopen	grch.
Metra	grch.
Mètre	frz.
Metreurysma	grch.
Metrik	grch.
Metritis	grch.
Metrocele	grch.
Metrologie	grch.
Metronymika	grch.
Metroptose	grch.
Metroskop	grch.
Metrotomie	grch.
Metrum	grch.
Mett	niederd.
Metterzià	ital.
Metteur en pages	frz.
Mezzadria	ital.
Mezzanin	ital.
Mezza voce	ital.
Mezzo	ital.
Mezzosopran	ital.
Mezzotinto	ital.
Miásma	grch.
Mica	frz.
Micha	hebr.
Michael	hebr.
Midgard	altnord.
Midrasch	hebr.
Midshipmen	engl.
Miflorence	frz.
Mignardise	frz.
Mignon	frz.
Mignonetten	frz.
Migration	lat.
Mihmandar	pers.
Mijotieren	frz.
Mikro...	grch.
Mikrobarometer	grch.
Mikrochemie	grch.
Mikrographie	grch.
Mikrokephalen	grch.
Mikrokósmos	grch.
Mikrolithen	grch.
Mikrolog	grch.
Mikromanie	grch.
Mikromegas	grch.
Mikrometer	grch.
Mikrophon	grch.
Mikropsie	grch.
Mikropyle	grch.
Mikroskop	grch.
Mikrotelephon	grch.
Mikrotom	grch.
Mikrozyten	grch.
Miles gloriosus	lat.
Miliar	lat.
Miliaria	lat.
Milieu	frz.
Militaria	lat.
Militarismus	neulat.
Milk-disease	engl.
Mille	lat.
Millefiori	ital.
Millennium	lat.
Milleraies	frz.
Milliarde	frz.
Milliarium	lat.
Millstone-grit	engl.
Mimen	grch.
Mimeograph	grch.
Mimiamben	grch.
Mimik	grch.
Mimikry	engl.
Mimisch	grch.
Mimodrama	grch.
Minargent	engl.
Mination	lat.
Minauderie	frz.
Minbar	arab.
Mincha	hebr.
Mine	frz.
Mineralien	neulat.
Mineralurgie	grch.
Minerogen	grch.
Minervae Promontorium	lat.
Mineur	frz.
Mineur	frz.
Minho	portug.
Minieren	frz.
Minimal	lat.
Minimen	lat.
Minimum	lat.
Minister	lat.
Ministerialen	mittellat.
Ministerium	lat.
Ministrieren	lat.
Minium	lat.
Minor	lat.
Minorat	neulat.
Minore	ital.
Minorénn	neulat.
Minuéndus	lat.
Minus	lat.
Minute	lat.
Minuzien	lat.
Miosis	grch.
Miotika	grch.
Mi-partitum	lat.
Mir	russ.
Mirabile dictu	lat.
Mirabilien	lat.
Mirage	frz.
Mirjam	hebr.
Mirza	pers.
Misandrie	grch.
Misanthrop	grch.
Mischna	hebr.
Mise	frz.
Miserabel	lat.
Misere	frz.
Miserere	lat.
Misericordia	lat.
Misogyn	grch.
Miß	engl.
Missa	lat.
Mission	lat.
Missive	lat.
Mister	engl.
Mistreß	engl.
Mitella	lat.
Mitigantia	lat.
Mitonnieren	frz.
Mitra	grch.
Mitraille	frz.
Mittimus	lat.
Miurisch	grch.
Mixtum	lat.
Mixtur	lat.
Mob	engl.
Mobil	lat.
Mobiliar	neulat.
Mobilien	lat.
Mobilität	lat.
Mockturtlesuppe	engl.
Modal	lat.
Modéll	ital.
Moderados	span.
Moderato	ital.
Moderieren	lat.
Modérn	spätlat.
Modést	lat.
Modifikation	lat.
Modulation	lat.
Modus	lat.
Mogigraphie	grch.
Mohair	engl.
Mohammed	arab.
Mohatra	arab.
Moiré	frz.
Mokánt	frz.
Molaren	lat.
Moleskin	engl.
Molestieren	lat.
Molette	frz.
Molybdobullon	grch.
Momént	lat.
Mômiers	frz.
Monadélphisch	grch.
Monadologie	grch.
Monandrisch	grch.
Monasterium	grch.
Monbijou	frz.
Mondain	frz.
Monepigraphisch	grch.
Moneren	grch.
Moneta	lat.
Monieren	lat.
Monísmus	grch.
Moniteur	frz.
Monition	lat.
Monitorium	lat.
Monochórd	grch.
Monochrom	grch.
Monocle	frz.
Monocycle	frz.
Monodrama	grch.
Monogamie	grch.
Monogen	grch.
Monogonie	grch.
Monográmm	grch.
Monographie	grch.
Monogynisch	grch.
Monoklinisch	grch.
Monokratie	grch.
Monolith	grch.
Monolog	grch.
Monomachie	grch.
Monomanie	grch.
Monomerie	grch.
Mononom	grch.
Monophasie	grch.
Monophyletisch	grch.
Monophysiten	grch.
Monopol	grch.
Monopteros	grch.
Monorchismus	grch.
Monosyllabum	grch.
Monosymmetrisch	grch.
Monothalamien	grch.
Monotheïsmus	grch.
Monotheleten	grch.
Monotom	grch.
Monoton	grch.
Monotrop	grch.
Monözisch	grch.
Monrepos	frz.
Monseigneur	frz.
Monsieur	frz.
Monsignore	ital.
Mons pietatis	lat.
Monster	engl.
Monstránz	spätlat.
Monströs	lat.
Montage	frz.
Montagnards	frz.
Montan	lat.
Mont-Cervin	frz.
Mont de piéte	frz.
Monte	ital.
Monte di pietà	ital.
Montejus	frz.
Montes	lat.
Monteur	frz.
Montieren	frz.
Mont Terglou	frz.
Monuméntum	lat.
Moosedeer	engl.
Moquette	frz.
Mora	lat.
Moral insanity	engl.
Moränen	frz.
Moratorium	lat.
Morbid	lat.
Morbilität	neulat.
Morbillen	neulat.
Morbleu	frz.
Morbosität	lat.
Morbus	lat.
Mordant	frz.
Mordoré	frz.
Moreen	engl.
Moréndo	ital.
Mores	lat.
Morfil	frz.
Morion	frz.
Moros	lat.
Morphologie	grch.
Morphotropie	grch.
Mortalität	lat.
Mortifizieren	lat.
Mortuarium	mittellat.
Morula	lat.
Mosaik	grch.
Mosso	ital.
Most Honourable	engl.
Mot d'ordre	frz.
Motette	ital.
Motilität	neulat.
Motion	lat.
Motiv	lat.
Motoren	lat.
Motuproprio	lat.
Mouchard	frz.
Mouche	frz.
Mouchoir	frz.
Mouillieren	frz.
Moulage	frz.
Moulinage	frz.
Moulinet	frz.
Moundbuilders	engl.
Moussieren	frz.
Moussons	frz.
Moustache	frz.
Moustille	frz.
Movens	lat.
Movieren	lat.
Moxa	span.
Mozzetta	ital.
Muchtar	arab.
Mudir	arab.
Mu'ézzin	arab.
Mufettisch	arab.
Mufti	arab.
Multipara	lat.
Multiplicativa	lat.
Multiplikation	lat.
Multiplikativ	lat.
Multiplikator	lat.
Multiplizieren	lat.
Multipräsénz	neulat.
Multivalént	neulat.
Multum, non multa	lat.
Mulus	lat.
Mumie	arab.
Mumifikation	neulat.
Mumps	engl.
Mundan	lat.
Mundant	lat.
Mundieren	lat.
Mundum	lat.
Munifizénz	lat.
Munimént	lat.
Munition	lat.
Munizipal	lat.
Muriatisch	lat.
Mus	lat.
Musagétes	grch.
Musca	lat.
Muschir	arab.
Musette	frz.
Museum	grch.
Mushik	russ.
Musik	grch.
Muskular	neulat.
Mutae	lat.
Mutabel	lat.
Mutation	lat.
Mutatis mutándis	lat.
Muten	altd.
Mutieren	lat.
Mutilation	lat.
Myalgie	grch.
Mycetes	grch.
Myelitis	grch.
Myelom	grch.
Myelopláxen	grch.
Mykologie	grch.
Mylady	engl.
Mylord	engl.
Mynheer	holl.
Myodynamometer	grch.
Myokardium	grch.
Myologie	grch.
Myom	grch.
Myopie	grch.
Myorrhexis	grch.
Myositis	grch.
Myospasmus	grch.
Myotomie	grch.
Myriade	grch.
Myringitis	grch.
Myriomorphoskop	grch.
Myriorama	grch.
Myrmekodomatien	grch.
Myrmekophilen	grch.
Myrmezismus	grch.
Mysost	dän.
Mystagog	grch.
Mysterien	grch.
Mysteriös	grch.
Mystifizieren	frz.
Mystisch	grch.
Mythographen	grch.
Mythologie	grch.
Mythus	grch.
Mytilotoxin	grch.
Myxödem	grch.
Myxom	grch.
Nadir	arab.
Näherung	mathem.
Nahije	türk.
Nahr	arab.
Nahum	hebr.
Nail	engl.
Najaden	grch.
Namjéstnik	russ.
Nänie	lat.
Nanosomie	grch.
Naos	grch.
Napolitaine	frz.
Narkotisch	grch.
Narrata refero	lat.
Narthex	grch.
Näs	skandinav.
Nasal	lat.
Natalitium martyris	lat.
Nathanael	hebr.
Nation	lat.
Nationalisieren	neulat.
Natives	engl.
Nativität	lat.
Natschálnik	russ.
Naturalia	lat.
Naturalismus	neulat.
Natural selection	engl.
Naturéll	frz.
Nauárch	grch.
Naukrarien	grch.
Naumachie	grch.
Nautical Almanac	engl.
Nautik	grch.
Naval	lat.
Navigation	lat.
Navigierung	lat.
Navikular	lat.
Nearthrose	grch.
Ne bis in idem	lat.
Nec aspera terrent	lat.
Necessaire	frz.
Negation	lat.
Negieren	lat.
Neglektion	lat.
Negligé	frz.
Negociateur	frz.
Negotium	lat.
Negoziabel	neulat.
Negro	engl.
Negus	äthiop.
Negus	engl.
Nehemia	hebr.
Neige	frz.
Nekrobiose	grch.
Nekrolatrie	grch.
Nekrolog	grch.
Nekromantie	grch.
Nekrose	grch.
Nekrotisch	grch.
Nektar	grch.
Nemesis	grch.
Nemoralien	lat.
Néo-grec	frz.
Neolithisch	grch.
Neologie	grch.
Neomyst	grch.
Neophyten	grch.
Neoplasma	grch.
Neoterisch	grch.
Neovitalismus	lat.
Neozoisch	grch.
Nephralgie	grch.
Nephritis	grch.
Ne quid nimis	lat.
Nequitien	lat.
Nero antico	ital.
Nerven	lat.
Nervös	frz.
Nervus	lat.
Netto	ital.
Neuerung	jurist.
Neuma	grch.
Neumen	grch.
Neuralgie	grch.
Neurapophysen	grch.
Neurasthenie	grch.
Neurilemma	grch.
Neuritis	grch.
Neurologie	grch.
Neurom	grch.
Neuromalakie	grch.
Neuron	grch.
Neuroparalyse	grch.
Neuroretinitis	grch.
Neurose	grch.
Neurotomie	grch.
Neutral	lat.
Neutralisieren	neulat.
Neutralität	neulat.
Neutrum	lat.
Névé	frz.
Nexus	lat.
Niaiserie	frz.
Niddui	hebr.
Niéllo	ital.
Nihil	lat.
Nihilum album	lat.
Nike	grch.
Niktitation	lat.
Nil admirari	lat.
Nimbus	lat.
Nippes	frz.
Nirwana	sanskrit.
Nischân	pers.
Niveau	frz.
Nivellement	frz.
Nivellieren	frz.
Nivose	frz.
Njemez	russ.
Nobiles	lat.
Noblesse	frz.
Nocturnum	lat.
Noesis	grch.
Noktambulismus	neulat.
Nolissement	frz.
Noma	grch.
Nomaden	grch.
Nomansland	engl.
Nomárch	grch.
Nombre	frz.
Nom de guerre	frz.
Nomen	lat.
Nomenklator	lat.
Nomina	lat.
Nominal	lat.
Nominalismus	mittellat.
Nomina sunt odiosa	lat.
Nomination	lat.
Nominativ	lat.
Nominieren	lat.
Nomos	grch.
Nonagon	grch.
Nonchalance	frz.
Non liquet	lat.
Non multa, sed multum	lat.
Nonne	kopt.
Nonobstánz	neulat.
Non olet	lat.
Nonpareil	frz.
Nonplusultra	lat.
Non possumus	lat.
Non-Resident	engl.
Non-restraint	engl.
Nonvalénz	lat.
Non-valeur	frz.
No-restraint	engl.
Noria	span.
Norm	lat.
Normieren	lat.
Nórnik	russ.
Nosce te ipsum	lat.
Nosogenie	grch.
Nostalgie	grch.
Nostrifikation	lat.
Nota	lat.
Notabeln	frz.
Nota bene	lat.
Notabilität	lat.
Notalgie	grch.
Notar	lat.
Nota romana	lat.
Notat	lat.
Noten	lat.
Notieren	lat.
Notifikation	lat.
Notiometer	grch.
Notion	lat.
Notiz	lat.
Notochórd	grch.
Notturno	ital.
Nova	lat.
Novantik	neulat.
Novation	lat.
Novelle	lat.
Novelle	ital.
Novene	ital.
Novitäten	lat.
Noviziat	neulat.
Novum	lat.
Noyaden	frz.
Nuance	frz.
Nubilös	lat.
Nuces	lat.
Nucleus	lat.
Nudation	lat.
Nugget	engl.
Nullifizieren	lat.
Nullität	neulat.
Numeralia	lat.
Numeri	lat.
Numerieren	lat.
Numerus	lat.
Numismatik	grch.
Nummus	lat.
Nunkupieren	lat.
Nunquam retrorsum	lat.
Nunziánt	lat.
Nunzium	lat.
Nunzius	lat.
Nuptial	lat.
Nutation	lat.
Nutrieren	lat.
Nux	lat.
Nyktalopie	grch.
Nymphomanie	grch.
Nystágmus	grch.
Oakum	engl.
Oasen	altägypt.
Oats	engl.
Obadja	hebr.
Obbligo	ital.
Obduktion	lat.
Obduration	lat.
Obediénz	lat.
Obelisk	grch.
Oberweibig	botan.
Obiit	lat.
Objékt	lat.
Objektiv	lat.
Oblastj	russ.
Oblaten	lat.
Oblation	lat.
Obligat	lat.
Obligeant	frz.
Obliteration	lat.
Oblongum	lat.
Obolos	grch.
Oboval	neulat.
Obrogieren	lat.
Obsekrieren	lat.
Observanten	lat.
Observánz	lat.
Observation	lat.
Observatorium	neulat.
Observieren	lat.
Obsessi	lat.
Obsignation	lat.
Obskur	lat.
Obsolet	lat.
Obstagium	mittellat.
Obstetrik	lat.
Obstinat	lat.
Obstipation	lat.
Obstruktion	lat.
Obszön	lat.
Obturator	lat.
Ochlokratie	grch.
Oculi	lat.
Oculus mundi	lat.
Odal	schwed.
Odds	engl.
Ode	grch.
Ödem	grch.
Oderint dum metuant	lat.
Odeur	frz.
Odiös	lat.
Odium	lat.
Odontagra	grch.
uvre	frz.
Offensiv	lat.
Offerieren	lat.
Offertorium	lat.
Office	frz.
Officium	lat.
Offizial	neulat.
Offiziánt	neulat.
Offizier	frz.
Offizin	lat.
Offizinéll	lat.
Offiziös	lat.
Ogham	kelt.
Ogival	frz.
Oitava	portug.
Okarina	ital.
Okkasion	lat.
Okkasionalismus	neulat.
Okkultation	lat.
Okkultismus	lat.
Okkupation	lat.
Okkurrénz	lat.
Ökologie	grch.
Ökonom	grch.
Oktaeder	grch.
Oktagon	grch.
Oktandrisch	grch.
Oktangulum	lat.
Oktánt	lat.
Oktav	lat.
Oktave	lat.
Oktodez	lat.
Oktogon	grch.
Oktogynisch	grch.
Oktroi	frz.
Oktroyieren	frz.
Oktuplieren	lat.
Okular	lat.
Okuli	lat.
Okulíst	frz.
Ökumenisch	grch.
Okzidént	lat.
Okzipital	lat.
Oleum	lat.
Olifant	altfrz.
Oligämie	grch.
Oligozythämie	grch.
Olitorisch	lat.
Olivetten	frz.
Olla podrida	span.
Olympioniken	grch.
Ombrés	frz.
Ombrometer	grch.
Omelette	frz.
Omen	lat.
Ominös	lat.
Omission	lat.
Omittieren	lat.
Omladina	serb.
Omne nimium nocet	lat.
Omnibus	lat.
Omnipotént	lat.
Omnium	lat.
Omnivoren	lat.
Omphalopsychoi	grch.
Onbaschi	türk.
Onça	portug.
On dit	frz.
Oneiromantie	grch.
Onera	lat.
Onerierter	lat.
Onkologie	grch.
Önolog	grch.
Onomástik	grch.
Onomastikon	grch.
Onomatologie	grch.
Onomatopöie	grch.
Önometer	grch.
Ontologie	grch.
Ontostatik	grch.
Onus	lat.
Onychie	grch.
Onza	span.
Onze et demi	frz.
Oogonium	grch.
Oologie	grch.
Oophoritis	grch.
Opak	lat.
Opanken	serb.
Opener	engl.
Opera	lat.
Operateur	frz.
Operation	lat.
Operette	ital.
Operieren	lat.
Ophikleide	grch.
Ophiodónten	grch.
Ophiolatrie	grch.
Ophiuchus	grch.
Ophthalmalgie	grch.
Opiophagen	grch.
Opisometer	grch.
Opisthotonus	grch.
Opora	grch.
Opponént	lat.
Opportun	lat.
Opposition	lat.
Oppression	lat.
Opprobration	lat.
Optativ	lat.
Optieren	lat.
Optik	grch.
Optima fide	lat.
Optimates	lat.
Optimus	lat.
Option	lat.
Optometer	grch.
Opulént	lat.
Opus	lat.
Opus operatum	lat.
Ora	lat.
Orakel	lat.
Oral	lat.
Orale	lat.
Orange	frz.
Orangelogen	engl.
Oratio	lat.
Oratorisch	lat.
Oratorium	lat.
Orbikular	lat.
Orbis	lat.
Orchéster	grch.
Orchestik	grch.
Orchitis	grch.
Ordalien	mittellat.
Ordinalia	lat.
Ordinär	lat.
Ordinarium	lat.
Ordinarius	lat.
Ordination	lat.
Ordines	lat.
Ordinieren	lat.
Ordo	lat.
Ordonnánz	frz.
Or doublé	frz.
Organ	grch.
Organon	grch.
Organotherapie	grch.
Orgásmus	grch.
Orgeade	frz.
Orgien	grch.
Orgue portatif	frz.
Orient	lat.
Original	lat.
Originär	lat.
Originéll	frz.
Orillon	frz.
Orkus	lat.
Orlándo furioso	ital.
Orlog	holländ.
Ornamént	lat.
Ornat	lat.
Ornitholithen	grch.
Ornithologie	grch.
Ornus	lat.
Orognosie	grch.
Orographie	grch.
Orologie	grch.
Orometrie	grch.
Orphaniten	grch.
Orthobiotik	grch.
Orthodoxie	grch.
Orthoëpie	grch.
Orthognath	grch.
Orthogon	grch.
Orthographie	grch.
Orthopädie	grch.
Orthopnöe	grch.
Orthoskopisch	grch.
Oryktogenie	grch.
Osculum	lat.
Oskulation	lat.
Osmologie	grch.
Ösophagus	grch.
Ossarium	lat.
Ostalgie	grch.
Ostealgie	grch.
Osteitis	grch.
Ostensibel	lat.
Ostension	lat.
Ostensiv	lat.
Ostensorium	neulat.
Ostentation	lat.
Osteologie	grch.
Ostiarius	lat.
Ostien	grch.
Ostinato	ital.
Ostitis	grch.
Ostium	lat.
Ostrazísmus	grch.
Oszillation	lat.
Otagra	grch.
Otalgie	grch.
Otaphon	grch.
Othämatom	grch.
Otiater	grch.
Otitis	grch.
Otium	lat.
Otologie	grch.
Otophon	grch.
Otozysten	grch.
Ottaverime	ital.
Oubliëtten	frz.
Où est la femme	frz.
Oules	frz.
Outrieren	frz.
Outsider	engl.
Ouverture	frz.
Ouvrier	frz.
Oval	neulat.
Ovarium	lat.
Ovation	lat.
Ovine	lat.
Oviparen	lat.
Ovula Graafiana	lat.
Ovulum	lat.
Ox-tail-soup	engl.
Oxymoron	grch.
Oxytonon	grch.
Ozäna	grch.
Ozean	grch.
Ozeanographie	grch.
Ozon	grch.
Pace	engl.
Pacem	lat.
Pachämie	grch.
Pachydermie	grch.
Pachymeningitis	grch.
Pachytrop	grch.
Pacific	engl.
Pacotille	frz.
Pactum	lat.
Pädagog	grch.
Pädagogium	grch.
Pädarthrokace	grch.
Pädatrophie	grch.
Paddock	engl.
Päderastie	grch.
Pädiater	grch.
Padischah	pers.
Pädogenesis	grch.
Pädotrophie	grch.
Padrone	ital.
Paganalien	lat.
Paganismus	lat.
Page	frz.
Pagerie	frz.
Pagina	lat.
Pägnion	grch.
Paignion	grch.
Paille	frz.
Pain	frz.
Pain Expeller	engl.
Pairs	frz.
Palais	frz.
Paläogen	grch.
Paläographie	grch.
Paläologie	grch.
Paläontographie	grch.
Paläontologie	grch.
Paläophytologie	grch.
Paläotypen	grch.
Paläozoologie	grch.
Palästra	grch.
Palatale	lat.
Palatina	lat.
Palatinus	lat.
Paleae	lat.
Pale Ale	engl.
Palefroi	frz.
Paletot	frz.
Palette	frz.
Palimpsést	grch.
Palindrom	grch.
Palingraphie	grch.
Palinodie	grch.
Palliativ	lat.
Pall-mall	engl.
Pallograph	grch.
Palma	lat.
Palmarium	lat.
Palmetten	frz.
Palmoskopie	grch.
Palmospasmus	grch.
Palpabel	lat.
Palpen	lat.
Palpitation	lat.
Paludaméntum	lat.
Paludismus	neulat.
Pampero	span.
Panade	frz.
Panaritium	lat.
Panazee	grch.
Pandékten	grch.
Pandemie	grch.
Pandora	grch.
Pandschab	pers.
Panegyrikus	grch.
Pangenesis	grch.
Panhagia	grch.
Panieren	frz.
Panikonographie	grch.
Panis	lat.
Pankration	grch.
Pankreas	grch.
Pankreatitis	grch.
Panmixie	grch.
Panne	frz.
Panneau	frz.
Pannus	lat.
Pannychis	grch.
Panorama	grch.
Panotitis	grch.
Pantalons	frz.
Pantheïsmus	grch.
Pantheon	grch.
Pantograph	grch.
Pantometer	grch.
Pantomime	grch.
Pantophagen	grch.
Pantry	engl.
Pänultima	lat.
Panurg	grch.
Panzerkrebs	mediz.
Papabiles	neulat.
Papal	neulat.
Papat	mittellat.
Papeterie	frz.
Papiermaché	frz.
Papilio	lat.
Papillote	frz.
Papísmus	neulat.
Paprika	ungar.
Papyrograph	grch.
Parabolisch	grch.
Parachute	frz.
Parade	frz.
Paradieren	frz.
Paradies	grch.
Paradigma	grch.
Parados	frz.
Paradóx	grch.
Paragenesis	grch.
Paragium	neulat.
Paragoge	grch.
Paragons	span.
Paragrámm	grch.
Paragraph	grch.
Paragraphie	grch.
Paraklet	grch.
Paralexie	grch.
Paralipomena	grch.
Paralipse	grch.
Parallage	grch.
Paralláxe	grch.
Parallel	grch.
Parallelepipedon	grch.
Parallelismus	grch.
Parallelográmm	grch.
Paralogie	grch.
Paraménte	lat.
Parameren	grch.
Parameros	span.
Parameter	grch.
Parametritis	grch.
Paramorphosen	grch.
Páramos	span.
Paramythie	grch.
Paränese	grch.
Paranoia	grch.
Paraphasie	grch.
Paraphe	frz.
Paraphérnen	grch.
Paraphimose	grch.
Paraphrase	grch.
Paraphrasie	grch.
Paraphysen	grch.
Parapluie	frz.
Parapodien	grch.
Paráschen	hebr.
Parasit	grch.
Parasol	frz.
Parästhesie	grch.
Parastichon	grch.
Parat	lat.
Par avance	frz.
Paravent	frz.
Parazentese	grch.
Parbleu	frz.
Parceria	portug.
Par-dessus	frz.
Pardon	frz.
Parenchym	grch.
Parentalien	lat.
Parentel	lat.
Parenthese	grch.
Parere	ital.
Parérga	grch.
Pares	lat.
Par et impar	lat.
Par excellence	frz.
Par exprès	frz.
Parfait	frz.
Parforce	frz.
Parfüm	frz.
Parfümerie	frz.
Parhelien	grch.
Parian	engl.
Pariation	lat.
Pari passu	lat.
Parish	engl.
Parisien	frz.
Parität	lat.
Parlamentär	frz.
Parlando	ital.
Parlatorium	neulat.
Parlieren	frz.
Parlierer	frz.
Parlour	engl.
Par nobile fratrum	lat.
Parodie	grch.
Parole	frz.
Paroli	span.
Parömie	grch.
Paronomasie	grch.
Par ordre	frz.
Parotis	grch.
Paroxysmus	grch.
Paroxytonon	grch.
Par préférence	frz.
Parquet	frz.
Parrain	frz.
Par renomée	frz.
Parrizida	lat.
Pars pro toto	lat.
Part	frz.
Parterre	frz.
Partes	lat.
Parthenien	grch.
Parthenogenesis	grch.
Partial	neulat.
Partie	frz.
Partiéll	frz.
Partikeln	lat.
Partikular	lat.
Partikulier	frz.
Partisan	frz.
Partition	lat.
Partizipánt	lat.
Partizipium	lat.
Partner	engl.
Partout	frz.
Parulis	grch.
Parusie	grch.
Parvenu	frz.
Parzelle	frz.
Pas	frz.
Paseng	pers.
Pasigraphie	grch.
Paso	span.
Paso	span.
Passabel	frz.
Passade	frz.
Passage	frz.
Passagieren	frz.
Passánt	frz.
Passanten	frz.
Passavant	frz.
Passe	frz.
Passeménten	frz.
Passen	frz.
Passeparole	frz.
Passepartout	frz.
Passepoil	frz.
Passeport	frz.
Passetemps	frz.
Passevolant	frz.
Passieren	frz.
Passionato	ital.
Passioniert	frz.
Passiv	lat.
Passivum	lat.
Passus	lat.
Pasta	ital.
Pastete	mittellat.
Pasticcio	ital.
Pastillen	lat.
Pastor	lat.
Pastorale	lat.
Pastos	ital.
Pastourelle	frz.
Patarener	ital.
Patella	lat.
Patene	lat.
Pater	lat.
Patera	lat.
Paterfamilias	lat.
Paternität	lat.
Paternoster	lat.
Pater patriae	lat.
Pater peccavi	lat.
Pâte sur pâte	frz.
Patetico	ital.
Pathetisch	grch.
Pathogen	grch.
Pathognomik	grch.
Pathologie	grch.
Pathophobie	grch.
Pathos	grch.
Patibulum	lat.
Patience	frz.
Patiént	lat.
Patin	frz.
Patina	lat.
Patisserie	frz.
Patois	frz.
Patres	lat.
Patria	lat.
Patria potestas	lat.
Patriarchen	grch.
Patrimonium	lat.
Patriot	grch.
Patrone	frz.
Patronymikon	grch.
Patrouille	frz.
Patrozinium	lat.
Patte	frz.
Pauken	student.
Pauperísmus	neulat.
Paupertät	lat.
Pause	lat.
Pavese	ital.
Pavillon	frz.
Pavillons noirs	frz.
Pavimént	lat.
Pax	lat.
Pax vobíscum	lat.
Paysage	frz.
Pays de Cocagne	frz.
Pazifikation	lat.
Paziszieren	lat.
Péage	frz.
Peak	engl.
Pea-nut	engl.
Peccatum	lat.
Pectus	lat.
Pecul	engl.
Peculatus	lat.
Peculium	lat.
Pedal	lat.
Pedánt	ital.
Pedéll	mittellat.
Pedéstrisch	lat.
Pediculus	lat.
Pedigree	engl.
Pedlar	engl.
Pedologie	grch.
Pedometer	grch.
Pegel	niederd.
Peies	hebr.
Peigneur	frz.
Peignoir	frz.
Peil	holländ.
Peintre-graveur	frz.
Peinture-mate	frz.
Peiraieus	altgrch.
Pejeration	lat.
Pejoration	lat.
Pektorale	lat.
Pektoralien	lat.
Pekuniär	lat.
Pekzieren	lat.
Pelade	frz.
Pelagisch	grch.
Pelerine	frz.
Pelham	engl.
Peliosis	grch.
Pellagra	ital.
Pelleterie	frz.
Pelluzid	lat.
Pelo	span.
Pelotage	frz.
Peloton	frz.
Pelvis	lat.
Penchant	frz.
Pendant	frz.
Pendeloque	frz.
Pendente lite	lat.
Pendentif	frz.
Penetrabel	lat.
Penibel	frz.
Peninsula	lat.
Penis	lat.
Peniténtes	span.
Penitentiary	engl.
Pennal	neulat.
Penne	hebr.
Penny	engl.
Penny-a-liner	engl.
Penpit	engl.
Pensée	frz.
Penseroso	ital.
Pension	frz.
Pensionär	frz.
Pensum	lat.
Pentadik	grch.
Pentaeder	grch.
Pentagon	grch.
Pentagrámm	grch.
Pentagynisch	grch.
Pentakosiomedímnen	grch.
Pentálpha	grch.
Pentameter	grch.
Pentándrisch	grch.
Pentapolis	grch.
Pentateuch	grch.
Pentathlon	grch.
Pentere	grch.
Penthemimeres	grch.
Pentimenti	ital.
Penultima	lat.
Penumbra	lat.
Peperino	ital.
Peperoni	ital.
Pepiniere	frz.
Peplos	grch.
Peptonurie	grch.
Peräa	grch.
Perambulator	lat.
Per appunto	ital.
Per aspera ad astra	lat.
Per aversionem	lat.
Per capita	lat.
Per cassa	ital.
Per contante	ital.
Per conto	ital.
Perdition	lat.
Perdurabel	lat.
Pereat	lat.
Peremtion	lat.
Perennierend	lat.
Per exemplum	lat.
Per expressum	lat.
Per fas et nefas	lat.
Perfékt	lat.
Perfektum	lat.
Perfid	lat.
Perforation	lat.
Perfusion	lat.
Pergola	ital.
Perhorreszieren	lat.
Perianthium	grch.
Periastrum	grch.
Peribole	grch.
Peribolos	grch.
Perical	ind.
Perichondrium	grch.
Periculum	lat.
Peridérm	grch.
Periegesis	grch.
Perigäum	grch.
Perigenesis	grch.
Perigon	grch.
Perigynisch	grch.
Perikárd	grch.
Perikarditis	grch.
Perikárp	grch.
Perikopen	grch.
Perikulös	lat.
Perimeter	grch.
Perimetritis	grch.
Perimorphose	grch.
Perineurium	grch.
Periöci	grch.
Periode	grch.
Perióst	grch.
Peripetie	grch.
Peripherie	grch.
Periphlebitis	grch.
Periphrase	grch.
Peripleuritis	grch.
Períplus	grch.
Peripteros	grch.
Periskopisch	grch.
Perispérm	grch.
Peristáltisch	grch.
Peristom	grch.
Peristyl	grch.
Perithezium	grch.
Peritonäum	grch.
Perityphlitis	grch.
Perizystitis	grch.
Perjurium	lat.
Perkal	pers.
Perkolation	lat.
Perkussion	lat.
Perkutieren	lat.
Perlustration	lat.
Permanént	lat.
Permanénz	lat.
Permeabel	lat.
Perméß	ital.
Per mille	lat.
Permíß	lat.
Permiszieren	lat.
Permittieren	lat.
Permixtion	lat.
Permutation	lat.
Perniziös	lat.
Perogrullo	span.
Perorieren	lat.
Per pedes	lat.
Perpendíkel	lat.
Perpetuéll	frz.
Perpetuum mobile	lat.
Perpléx	lat.
Per procura	ital.
Perquirieren	lat.
Perron	frz.
Per saldo	ital.
Per se	lat.
Persekution	lat.
Perseveránz	lat.
Persiennes	frz.
Persiflage	frz.
Persiko	ital.
Persistént	lat.
Personal	lat.
Personalien	lat.
Personalität	neulat.
Personifikation	lat.
Personnage	frz.
Perspektiv	lat.
Perspektive	lat.
Perspiration	lat.
Persuadieren	lat.
Pertinenzien	lat.
Perturbation	lat.
Perücke	frz.
Pervérs	lat.
Pervigilium	lat.
Perzeptibilität	neulat.
Perzipieren	lat.
Pesade	frz.
Pessarium	lat.
Petalum	lat.
Petarde	frz.
Petechien	neulat.
Petént	lat.
Petillieren	frz.
Petit	frz.
Petit-crevé	frz.
Petition	lat.
Petition of right	engl.
Petitio principii	lat.
Petit mal	frz.
Petitor	lat.
Petra	grch.
Petrobolen	grch.
Petrographie	grch.
Petroleur	frz.
Petrówitsch	russ.
Petschaft	slaw.
Petto	ital.
Petulánt	lat.
Peu à peu	frz.
Pewter	engl.
Phagedäna	grch.
Phagozyten	grch.
Phalanstère	frz.
Phalanx	grch.
Phänakistoskop	grch.
Phanerogamen	grch.
Phanerokristallin	grch.
Phaneromer	grch.
Phänologie	grch.
Phänomen	grch.
Phantasie	grch.
Phantásma	grch.
Phantást	grch.
Phantom	grch.
Phantoskop	grch.
Pharmakodynamik	grch.
Pharmakognosie	grch.
Pharmakologie	grch.
Pharmakon	grch.
Pharmakopöe	grch.
Pharmazeut	grch.
Pharmazie	grch.
Pharyngitis	grch.
Pharyngologie	grch.
Phasen	grch.
Phelloplástik	grch.
Phiale	grch.
Philadélphus	grch.
Philalethes	grch.
Philanthropie	grch.
Philatelie	grch.
Philharmonisch	grch.
Philhellenen	grch.
Philogyn	grch.
Philolog	grch.
Philologie	grch.
Philosoph	grch.
Philosophem	grch.
Philosophie	grch.
Philosophieren	grch.
Philoxenie	grch.
Philtron	grch.
Phimose	grch.
Phlebektasie	grch.
Phlegma	grch.
Phlegmasie	grch.
Phlegmatiker	grch.
Phlegmone	grch.
Phloem	grch.
Phlogiston	grch.
Phlogosis	grch.
Phlyktäne	grch.
Phobos	grch.
Phoibos	grch.
Phonautograph	grch.
Phonetik	grch.
Phonik	grch.
Phonisch	grch.
Phonograph	grch.
Phonograhie	grch.
Phonologie	grch.
Phonometer	grch.
Phonopléx	grch.
Phorminx	grch.
Phoronomie	grch.
Photochemie	grch.
Photochromie	grch.
Photochromographie	grch.
Photochronograph	grch.
Photogalvanographie	grch.
Photogrammetrie	grch.
Photographie	grch.
Photogravüre	frz.
Photohyalographie	grch.
Photokeramik	grch.
Photolithographie	grch.
Photometer	grch.
Photophobie	grch.
Photophon	grch.
Photoskop	grch.
Photosphäre	grch.
Photostigmographie	grch.
Phototéchnik	grch.
Phototherapie	grch.
Phototopographie	grch.
Phototropismus	grch.
Phototypie	grch.
Photoxylographie	grch.
Phrase	grch.
Phratrien	grch.
Phrenesie	grch.
Phrenologie	grch.
Phrenopathie	grch.
Phthiriasis	grch.
Phthisis	grch.
Phykologie	grch.
Phylakterium	grch.
Phylax	grch.
Phýle	grch.
Phylloblásten	grch.
Phyllodien	grch.
Phyllom	grch.
Phyllotáxis	grch.
Phyma	grch.
Physem	grch.
Physeter	grch.
Physiater	grch.
Physik	grch.
Physikus	grch.
Physiognomie	grch.
Physiographie	grch.
Physiokratismus	grch.
Physiologie	grch.
Physiologus	grch.
Physionomie	grch.
Physioplástik	grch.
Physisch	grch.
Phytogen	grch.
Phytolithen	grch.
Phytotherapie	grch.
Phytozoen	grch.
Pia causa	lat.
Piacevole	ital.
Pia desideria	lat.
Piaffe	frz.
Pia fraus	lat.
Pia mater	lat.
Piae memoriae	lat.
Pianino	ital.
Piano	ital.
Pianoforte	ital.
Pians	frz.
Piatti	ital.
Piazza	ital.
Pice	engl.
Picknick	engl.
Pickpocket	engl.
Pico	span.
Pié	span.
Pièce	frz.
Piëdestal	frz.
Piedfort	frz.
Pier	engl.
Pierre	frz.
Pierrot	frz.
Piëtà	ital.
Pietra verde	ital.
Piëzoelektrizität	grch.
Piëzometer	grch.
Piffero	ital.
Pigeons	frz.
Pigmént	lat.
Piis manibus	lat.
Pikieren	frz.
Pikkolo	ital.
Pilar	span.
Piláster	frz.
Pilchard	engl.
Pilieren	frz.
Pilot	holländ.
Pilum	lat.
Pimelosis	grch.
Pimiënto	span.
Pinakel	lat.
Pinakoid	grch.
Pinakoskop	grch.
Pinakothek	grch.
Pincenez	frz.
Pinchbeak	engl.
Pinetum	lat.
Pinkcolour	engl.
Pinna	lat.
Pint	engl.
Pinxit	lat.
Piombi	ital.
Pion	frz.
Pioskop	grch.
Pipette	frz.
Pique	frz.
Piqué	frz.
Piquet	frz.
Piqûre	frz.
Pirat	lat.
Pirouette	frz.
Pis-aller	frz.
Piscina	lat.
Pisé	frz.
Pistíll	lat.
Pistoles	frz.
Pistolet	frz.
Piston	frz.
Pitch pine	engl.
Pithometer	grch.
Pittorésk	ital.
Pituitös	lat.
Pityriasis	grch.
Piú	ital.
Pium corpus	lat.
Piva	ital.
Pivot	frz.
Pizzicato	ital.
Pizzo	ital.
Placage	frz.
Placard	frz.
Placement	frz.
Placet	lat.
Placieren	frz.
Plafond	frz.
Plagium	lat.
Plagoskop	grch.
Plaid	engl.
Plaidieren	frz.
Plakabel	lat.
Plakat	mittellat.
Plakieren	frz.
Plan	lat.
Planar	lat.
Planchette	frz.
Planetarium	lat.
Planeten	grch.
Planieren	lat.
Planigloben	lat.
Planina	bulgar.
Plankton	grch.
Plantage	frz.
Planum	lat.
Plaque	frz.
Plaqué	frz.
Plaquettes	frz.
Plasma	grch.
Plasmogonie	grch.
Plastiden	grch.
Plastidule	grch.
Plástik	grch.
Plastizität	frz.
Plastograph	grch.
Plastron	frz.
Plateau	frz.
Platform	engl.
Platinen	frz.
Platitude	frz.
Plausibel	lat.
Plazénta	lat.
Plazitum	lat.
Plebanus	mittellat.
Plebiszit	lat.
Pleias	grch.
Pleinpouvoir	frz.
Pleiochasium	grch.
Plektron	grch.
Plenarium	lat.
Plenipoténz	neulat.
Pleochroïsmus	grch.
Pleomorphismus	grch.
Pleonasmus	grch.
Plesiopsie	grch.
Plessimeter	grch.
Plethora	grch.
Pleura	grch.
Pleurapophysen	grch.
Pleureuse	frz.
Pleuritis	grch.
Pleurodónt	grch.
Pleurodynie	grch.
Pleuropneomonie	grch.
Plexus	lat.
Pli	frz.
Plinthe	grch.
Plissee	frz.
Plongé	frz.
Ployieren	frz.
Plumage	frz.
Plumbum	lat.
Plumeau	frz.
Plumpudding	engl.
Plumula	lat.
Pluralismus	neulat.
Plus	lat.
Plusquamperfektum	lat.
Plutokratie	grch.
Pluviale	lat.
Pluvius	lat.
Pneuma	grch.
Pneumatik	grch.
Pneumatisch	grch.
Pneumatismus	grch.
Pneumatochórd	grch.
Pneumatograph	grch.
Pneumatologie	grch.
Pneumatometer	grch.
Pneumatosis	grch.
Pneumatotherapie	grch.
Pneumobiomántik	grch.
Pneumograph	grch.
Pneumolithen	grch.
Pneumonektasie	grch.
Poccetta	ital.
Poche	frz.
Pochette	frz.
Poco	ital.
Podagra	grch.
Podalgie	grch.
Podarthrokace	grch.
Podex	lat.
Podium	lat.
Podometer	grch.
Poësie	grch.
Poet	lat.
Poetik	grch.
Pogróm	russ.
Poil	frz.
Point	frz.
Pointe	frz.
Pointer	engl.
Pointieren	frz.
Point-lace	engl.
Points	frz.
Pol	grch.
Polacca	ital.
Polarität	neulat.
Polemárchos	grch.
Polemik	grch.
Polénta	ital.
Polias	grch.
Police	frz.
Polichinelle	frz.
Polieren	lat.
Poliklinik	grch.
Poliment	frz.
Polioenkephalitis	grch.
Poliomyelitis	grch.
Poliorketes	grch.
Poliosis	grch.
Polisson	frz.
Politesse	frz.
Politik	grch.
Politisch	grch.
Politur	lat.
Pollution	lat.
Polonäse	frz.
Poltron	frz.
Polyadélphisch	grch.
Polyandrie	grch.
Polyandrisch	grch.
Polyarchie	grch.
Polyarthritis	grch.
Polyästhesie	grch.
Polyautographie	grch.
Polychromie	grch.
Polychromographie	grch.
Polydaktylie	grch.
Polydipsie	grch.
Polyeder	grch.
Polyembryonie	grch.
Polygamie	grch.
Polygamisch	grch.
Polyglotte	grch.
Polygon	grch.
Polygraph	grch.
Polygynisch	grch.
Polyhämie	grch.
Polyhístor	grch.
Polykephalisch	grch.
Polykladie	grch.
Polymastie	grch.
Polymathie	grch.
Polymelie	grch.
Polymerie	grch.
Polymeter	grch.
Polymetrie	grch.
Polymórph	grch.
Polynom	grch.
Polypen	grch.
Polyphag	grch.
Polyphon	grch.
Polyphrasie	grch.
Polyphyletisch	grch.
Polyptychon	grch.
Polysarkie	grch.
Polyspermie	grch.
Polysynthetisch	grch.
Polythalamien	grch.
Polytheïsmus	grch.
Polytrop	grch.
Polytypen	grch.
Polyurie	grch.
Pomade	frz.
Pompadour	frz.
Pompon	frz.
Ponceau	frz.
Poncette	frz.
Poncho	span.
Poncieren	frz.
Ponciren	frz.
Ponderabel	lat.
Ponénte	ital.
Ponerologie	grch.
Ponieren	lat.
Ponies	engl.
Pönitentiale	lat.
Pönitentiarius	mittellat.
Pöniténz	lat.
Pons Varolii	lat.
Ponticello	ital.
Pontieren	frz.
Pontifex	lat.
Pontificale Romanum	lat.
Pontifikalien	lat.
Pontifikat	lat.
Ponton	frz.
Pony	engl.
Ponzinen	ital.
Poop	engl.
Populär	lat.
Population	lat.
Populus	lat.
Poren	grch.
Pornograph	grch.
Porotypie	grch.
Porphyrogennetos	grch.
Porrigo	lat.
Portabel	lat.
Portage	frz.
Porta Hungarica	lat.
Portatile	ital.
Portativ	lat.
Portechaise	frz.
Portefeuille	frz.
Portemonnaie	frz.
Portepee	frz.
Porteur	frz.
Portier	frz.
Portikus	lat.
Porto	ital.
Portolano	ital.
Portulan	frz.
Porzellan	portug.
Posada	span.
Pose	niederd.
Pose	frz.
Poseur	frz.
Posieren	frz.
Position	lat.
Positiv	lat.
Positur	lat.
Posséß	lat.
Posséssor	lat.
Possibel	lat.
Postamént	neulat.
Postdatieren	lat.
Poste restante	frz.
Posteri	lat.
Post festum	lat.
Postieren	frz.
Postille	lat.
Postliminium	lat.
Postnumerándo	neulat.
Posto	ital.
Postponieren	lat.
Postremität	lat.
Post Romam conditam	lat.
Postskriptum	lat.
Postulánt	lat.
Postulat	lat.
Pot	frz.
Potamologie	grch.
Potator	lat.
Pot-au-feu	frz.
Potént	lat.
Potential	lat.
Poténz	lat.
Poterie	frz.
Poterne	frz.
Potio	lat.
Potpourri	frz.
Poudre	frz.
Poudrette	frz.
Poularden	frz.
Poule	frz.
Pound	engl.
Pourboire	frz.
Pourparler	frz.
Poussieren	frz.
Pouvoir	frz.
Prae	lat.
Präambel	lat.
Präbénde	lat.
Prädamnation	lat.
Prädestination	lat.
Prädeterminieren	lat.
Prädial	lat.
Prädikamént	lat.
Prädikánt	lat.
Prädikat	lat.
Prädilektion	lat.
Prädisponieren	lat.
Prädizieren	lat.
Prädominieren	lat.
Präeminénz	lat.
Präexisténz	lat.
Praefatio	lat.
Präferénz	lat.
Präfigieren	lat.
Präformation	lat.
Präglazial	lat.
Prägnánt	lat.
Praguerie	frz.
Prähistorie	neulat.
Prairial	frz.
Prairie	frz.
Präjudiz	lat.
Präkaution	lat.
Präkludieren	lat.
Präkordien	lat.
Práktik	grch.
Präkursorisch	lat.
Prälat	lat.
Prälegat	lat.
Präliminar	neulat.
Pralinés	frz.
Präludieren	lat.
Prämaturität	lat.
Prämeditation	lat.
Prämie	lat.
Prämisse	lat.
Praemissis praemitténdis	lat.
Prämolaren	neulat.
Prämortal	neulat.
Pränomen	lat.
Pränumerándo	neulat.
Präokkupation	lat.
Präparánd	lat.
Präparat	lat.
Präparation	lat.
Präponderánz	lat.
Präponieren	lat.
Präposition	lat.
Präpositus	lat.
Präpoténz	lat.
Präputium	lat.
Präsens	lat.
Präsént	lat.
Präsentánt	lat.
Präsénz	lat.
Präsepe	lat.
Präservation	lat.
Präses	lat.
Präsidént	lat.
Präsidial	lat.
Präskribieren	lat.
Prästabel	lat.
Prästabilieren	lat.
Prästánz	lat.
Prästieren	lat.
Präsumieren	lat.
Prätendént	lat.
Präterieren	lat.
Präteritum	lat.
Praeter propter	lat.
Prätéxt	lat.
Prätor	lat.
Praetorium	lat.
Prävalieren	lat.
Prävarikation	lat.
Prävenieren	lat.
Prävigilien	lat.
Prawosláwnyje	russ.
Praxis	grch.
Präzedéns	lat.
Präzéptor	lat.
Präzession	lat.
Präzéssor	lat.
Präzipieren	lat.
Präzipitantia	lat.
Präzipuum	lat.
Präzis	lat.
Pecipitándo	ital.
Predella	ital.
Preference	frz.
Prekarium	lat.
Premier	frz.
Presbyopie	grch.
Presbyter	grch.
Presepio	ital.
Presidios	span.
Pressánt	frz.
Pressentiment	frz.
Pressieren	lat.
Prestidigitateur	frz.
Prestige	frz.
Prestigiateur	frz.
Presto	ital.
Pretium	lat.
Prévôt	frz.
Preziös	lat.
Prima	lat.
Primadonna	ital.
Primage	frz.
Primas	lat.
Prima vista	ital.
Prime	lat.
Primipara	lat.
Primitiv	lat.
Primiz	lat.
Primizien	lat.
Primogenitur	neulat.
Primordial	lat.
Primrose League	engl.
Primum mobile	lat.
Primus	lat.
Princeps	lat.
Principaliter	lat.
Principiis obsta	lat.
Prinzipal	lat.
Prinzipat	lat.
Príor	lat.
Priorität	lat.
Prise	frz.
Prisma	grch.
Prístaw	russ.
Privat	lat.
Privata	lat.
Privatdozent	lat.
Privatim	lat.
Privation	lat.
Privatissime	lat.
Privé	frz.
Privilegium	lat.
Pro aris et focis	lat.
Probabel	lat.
Probabilismus	neulat.
Probandus	lat.
Probat	lat.
Probation	lat.
Probatum est	lat.
Probität	lat.
Problem	grch.
Probrachys	grch.
Proceres	lat.
Proctor	engl.
Procul negotiis	lat.
Prodigalität	lat.
Prodigium	lat.
Pro domo	lat.
Prodromus	grch.
Prodúkt	lat.
Produktion	lat.
Produktiv	lat.
Produzieren	lat.
Proëminenz	lat.
Pro et contra	lat.
Profan	lat.
Proféß	lat.
Profession	lat.
Proféssor	lat.
Profil	frz.
Profít	frz.
Pro forma	lat.
Profúnd	lat.
Profus	lat.
Progenitur	lat.
Prognath	grch.
Prognose	grch.
Prognostikon	grch.
Prográmm	grch.
Progréß	lat.
Prohibieren	lat.
Projékt	lat.
Projektil	neulat.
Projektion	lat.
Projéktor	lat.
Projizieren	lat.
Proklamation	lat.
Proklitikon	grch.
Prokrústes	grch.
Proktalgie	grch.
Prokura	lat.
Prokuration	lat.
Prokurór	russ.
Prolápsus	lat.
Prolegat	lat.
Prolegomena	grch.
Prolepsis	grch.
Proletarier	lat.
Prolog	grch.
Prolongation	lat.
Prolongement	frz.
Proludieren	lat.
Promachos	grch.
Promemoria	lat.
Promenade	frz.
Promesse	frz.
Promille	lat.
Prominént	lat.
Pro ministerio	lat.
Promiscue	lat.
Promission	lat.
Promittieren	lat.
Promontorium	lat.
Promotion	lat.
Prompt	lat.
Promulgieren	lat.
Pro mundo	lat.
Pronaos	grch.
Pro nihilo	lat.
Pronomen	lat.
Prononcieren	frz.
Pronuba	lat.
Pronunziation	lat.
Propädeutik	grch.
Propagánda	lat.
Propagation	lat.
Proparoxytónon	grch.
Pro patria	lat.
Properispomenon	grch.
Propheten	grch.
Prophetie	grch.
Prophyláktisch	grch.
Prophyláxe	grch.
Propination	lat.
Proponieren	lat.
Proportion	lat.
Proposition	lat.
Propre	frz.
Propria manu	lat.
Proprietär	lat.
Propulsion	lat.
Propyläen	grch.
Pro rata	lat.
Proréktor	neulat.
Prorogation	lat.
Prosa	lat.
Pro saldo	ital.
Proséktor	lat.
Prosekution	lat.
Proselyt	grch.
Prosenchym	grch.
Prosit	lat.
Proskribieren	lat.
Proskynesis	grch.
Prosodie	grch.
Prosopalgie	grch.
Prospékt	lat.
Prosperieren	lat.
Prossimo	ital.
Prostata	grch.
Prosternieren	lat.
Prostituieren	lat.
Prostitution	lat.
Proszenium	lat.
Protagoníst	grch.
Protegé	frz.
Protektion	lat.
Proterandrie	grch.
Protést	lat.
Protestanten	lat.
Protestation	lat.
Protevangelium	grch.
Prothallium	grch.
Prothese	grch.
Protísten	grch.
Protogen	grch.
Protokóll	grch.
Protomartyr	grch.
Protonema	grch.
Proton Pseudos	grch.
Protoplásma	grch.
Protopope	grch.
Prototyp	grch.
Protraktion	lat.
Protuberánz	lat.
Protypisch	grch.
Proveniénz	neulat.
Proverbes	frz.
Proviánt	ital.
Provinzial	lat.
Provinzialismus	neulat.
Provision	lat.
Provisor	lat.
Provisorisch	lat.
Provokation	lat.
Provost	engl.
Provozieren	lat.
Provveditore	ital.
Proxenie	grch.
Prozedieren	lat.
Prozéß	lat.
Prozession	lat.
Prozymiten	grch.
Prüde	frz.
Psaligraphie	grch.
Psallieren	grch.
Psalm	grch.
Psammit	grch.
Psammom	grch.
Psephisma	grch.
Pseudarthrosis	grch.
Pseudepigraphen	grch.
Pseudodoxie	grch.
Pseudoerysipel	grch.
Pseudoleukämie	grch.
Pseudomorphosen	grch.
Pseudonym	grch.
Pseudoplasma	grch.
Pseudopodien	grch.
Pseudoskop	grch.
Pseudosmie	grch.
Psilosis	grch.
Psittakosis	grch.
Psoa	grch.
Psora	grch.
Psoriasis	grch.
Psychagogos	grch.
Psyche	grch.
Psychiater	grch.
Psychisch	grch.
Psychodrama	grch.
Psychograph	grch.
Psychologie	grch.
Psychomantie	grch.
Psychometrie	grch.
Psychopannychie	grch.
Psychopathologie	grch.
Psychopómpos	grch.
Psychosen	grch.
Psychotherapie	grch.
Psychrometer	grch.
Psychrophor	grch.
Pterygium	grch.
Ptisane	grch.
Ptyalagoga	grch.
Pubertät	lat.
Publik	lat.
Publikándum	lat.
Publikation	lat.
Publikum	lat.
Publizieren	lat.
Puër	lat.
Puërpera	lat.
Puërto	span.
Pugilíst	lat.
Pulex	lat.
Pulgada	span.
Pullen	engl.
Pulmo	lat.
Pulpa	lat.
Pulper	engl.
Pulpitum	lat.
Pulpös	lat.
Pulque	span.
Pulsation	lat.
Pulverisateur	frz.
Pulvinar	lat.
Pulvis	lat.
Punch	engl.
Punctum	lat.
Punktation	neulat.
Punktion	lat.
Punktur	lat.
Punta	ital.
Pupillar	lat.
Pupille	lat.
Pupillen	lat.
Pur	lat.
Püree	frz.
Purifikation	lat.
Purismus	lat.
Purität	lat.
Purpur	lat.
Purree	engl.
Purulént	lat.
Pustel	lat.
Putation	lat.
Puteal	lat.
Putrid	lat.
Pyämie	grch.
Pyarthros	grch.
Pygmäen	grch.
Pyknometer	grch.
Pylephlebektasie	grch.
Pylonen	grch.
Pylorus	grch.
Pyon	grch.
Pyramide	grch.
Pyretika	grch.
Pyrheliometer	grch.
Pyrit	grch.
Pyrobolik	grch.
Pyrogen	grch.
Pyrolatrie	grch.
Pyromanie	grch.
Pyrometer	grch.
Pyrophag	grch.
Pyrophon	grch.
Pyrophor	grch.
Pyrosis	grch.
Pyroskop	grch.
Pyrosphäre	grch.
Pyrotéchnik	grch.
Pyrotypie	grch.
Pythonomorphen	grch.
Pyurie	grch.
Pyxis	grch.
Quadragesima	lat.
Quadrans	lat.
Quadránt	lat.
Quadrat	lat.
Quadratum incusum	lat.
Quadratur	lat.
Quadriënnium	lat.
Quadrieren	lat.
Quadrifolium	neulat.
Quadriga	lat.
Quadrillion	neulat.
Quadrireme	lat.
Quadrivium	lat.
Quadrupel	lat.
Quai	frz.
Qualifikation	lat.
Qualität	lat.
Quand même	frz.
Quantität	lat.
Quantité négligeable	frz.
Quantum	lat.
Quarantäne	frz.
Quart	lat.
Quarta	lat.
Quarta Falcidia	lat.
Quartal	lat.
Quartan	lat.
Quartánt	neulat.
Quartär	lat.
Quarte	lat.
Quartétt	ital.
Quartier	frz.
Quartiermeister	militär.
Quasi	lat.
Quasimodogeniti	lat.
Quasi re bene gesta	lat.
Quasiususfruktus	lat.
Quaestio	lat.
Quaternär	lat.
Quatérne	lat.
Quatrain	frz.
Quatriduum	lat.
Quatuor	lat.
Quercus	lat.
Querelle d'Allemand	frz.
Querulánt	lat.
Queue	frz.
Quidam	lat.
Quid juris	lat.
Quidproquo	lat.
Quidquid agis, prudénter agas et respice finem	lat.
Quidquid delirant reges, plectuntur Achivi	lat.
Quidquid id est, timeo Danaos et dona feréntes	lat.
Quiëszieren	lat.
Quieta non movere	lat.
Qui mange du pape, en meurt	frz.
Quincaillerie	frz.
Qui nimium probat, nihil probat	lat.
Quinkunx	lat.
Quinquagesimä	lat.
Quinquennium	lat.
Quinquillion	neulat.
Quinta	lat.
Quintal	frz.
Quintan	lat.
Quinte	lat.
Quintérne	lat.
Quinteronen	span.
Quintétt	ital.
Quintilis	lat.
Quintuplum	lat.
Quiproquo	lat.
Qui s'excuse, s'accuse	frz.
Quisisana	ital.
Quis. quid, ubi, quibus auxiliis, cur, quomodo, quando	lat.
Quisquilien	lat.
Quittieren	frz.
Qui vive	frz.
Qui vivra, verra	frz.
Quod bonum, felix faustumque sit	lat.
Quod Deus bene vertat	lat.
Quod erat demonstrándum	lat.
Quodlibet	lat.
Quod licet Jovi, non licet bovi	lat.
Quod non est in actis, non est in mundo	lat.
Quorum	engl.
Quos (Quem) deus perdere vult, prius deméntat	lat.
Quos ego!	lat.
Quod capita, tot sensus	lat.
Quote	lat.
Quotidian	lat.
Quotiént	lat.
Quotität	neulat.
Quoúsque tandem	lat.
Rabátt	ital.
Rabátte	frz.
Rabbes	hebr.
Rabbi	hebr.
Rabbiat	ital.
Rabiat	ital.
Rabies	lat.
Rabouge	frz.
Race	frz.
Race	engl.
Racemös	lat.
Racket	engl.
Radesyge	norweg.
Radial	lat.
Radiär	frz.
Radiation	lat.
Radiator	neulat.
Radieren	lat.
Radiieren	lat.
Radikánd	lat.
Radius	lat.
Radizieren	lat.
Radotieren	frz.
Raffinade	frz.
Raffinement	frz.
Raffinerie	frz.
Raffinieren	frz.
Rage	frz.
Ragout	frz.
Rahel	hebr.
Raid	schott.
Railway-spine	engl.
Raison	frz.
Rajah	arab.
Rallentándo	ital.
Ralliement	frz.
Ramadou	frz.
Rameaux	frz.
Ramifikation	lat.
Rampe	frz.
Rana	lat.
Rangieren	frz.
Ranküne	frz.
Ranula	lat.
Ranz des vaches	frz.
Rapee	frz.
Raphael	hebr.
Raphanie	grch.
Raphe	grch.
Rapid	lat.
Rapier	frz.
Rapilli	ital.
Rappéll	frz.
Rappórt	frz.
Rapprochieren	frz.
Raptus	lat.
Rar	lat.
Rarität	lat.
Râs	arab.
Rasánt	frz.
Rasieren	frz.
Raskólniken	russ.
Rasur	lat.
Ratafia	ital.
Rate	lat.
Ratifikation	neulat.
Ratin	frz.
Ratio	lat.
Ration	frz.
Rational	lat.
Rationalität	lat.
Ravage	frz.
Ravelin	frz.
Ravin	frz.
Rayon	frz.
Razzia	arab.
Reader	engl.
Reädifikation	lat.
Reagens	lat.
Reagieren	lat.
Reaktion	lat.
Reaktivieren	frz.
Real	lat.
Realien	lat.
Realinjurie	lat.
Realisation	frz.
Realismus	neulat.
Realität	lat.
Rear-admiral	engl.
Reassekuránz	neulat.
Reassumtion	neulat.
Reat	lat.
Rebéll	lat.
Rebî	arab.
Redondieren	frz.
Rebut	frz.
Receiver	engl.
Recherche	frz.
Recipe	lat.
Recitando	ital.
Reclusi	lat.
Recours comme d'abus	frz.
Recursus ab abusu	lat.
Redakteur	frz.
Redan	frz.
Redemtion	lat.
Redhibition	lat.
Redif	arab.
Redigieren	lat.
Redingote	frz.
Redivivus	lat.
Redoute	frz.
Redressieren	frz.
Reduit	frz.
Reduktion	lat.
Redundánz	lat.
Reduplikation	lat.
Reduzieren	lat.
Redwood	engl.
Reéll	frz.
Reep	niedersächs.
Refaktie	holländ.
Refektorium	lat.
Referat	neulat.
Referendar	neulat.
Referéndum	lat.
Referénz	lat.
Referieren	lat.
Reflektieren	lat.
Refléx	lat.
Reflexion	lat.
Reflexiv	lat.
Refórm	neulat.
Reformatio in pejus	lat.
Reformation	lat.
Reformator	lat.
Reformer	engl.
Reformieren	lat.
Refraichieren	frz.
Refrain	frz.
Refraktär	frz.
Refraktion	lat.
Refrigeration	lat.
Réfugiés	frz.
Refugium	lat.
Refulgénz	lat.
Refus	frz.
Refutation	lat.
Regal	lat.
Regalieren	frz.
Regardieren	frz.
Regatta	ital.
Regelation	lat.
Regeneration	lat.
Regens	lat.
Regént	lat.
Regésten	lat.
Régicides	frz.
Regie	frz.
Regime	frz.
Regimént	lat.
Regio	lat.
Region	lat.
Register	mittellat.
Registered	engl.
Reglement	frz.
Regletten	frz.
Reglisse	frz.
Regréß	lat.
Regressiv	lat.
Regula falsi	lat.
Regulär	lat.
Regulares	lat.
Regulativ	neulat.
Regulator	lat.
Regulieren	lat.
Regulus	lat.
Rehabeam	hebr.
Rehabilitation	neulat.
Reihe	mathem.
Reïmpression	neulat.
Reineclaude	frz.
Reinette	frz.
Reïnstallieren	neulat.
Reïteration	lat.
Reï vindicatio	lat.
Rejektion	lat.
Rekadénz	neulat.
Rekapitulation	lat.
Reklamation	lat.
Reklame	frz.
Reklamieren	lat.
Rekognition	lat.
Rekognoszieren	lat.
Rekollekten	lat.
Rekommandation	frz.
Rekomparation	neulat.
Rekompéns	neulat.
Rekonstruieren	neulat.
Rekonvaleszént	neulat.
Rekonziliation	lat.
Rekord	engl.
Rekreation	lat.
Rekrimination	neulat.
Rektangulum	lat.
Rektaszension	lat.
Rektifikation	lat.
Rektion	lat.
Rektor	lat.
Rekurrieren	lat.
Rekúrs	lat.
Rekusation	lat.
Relais	frz.
Relapsing fever	engl.
Relata refero	lat.
Relation	lat.
Relativ	lat.
Relegation	lat.
Relevánt	lat.
Relief	frz.
Religiosen	lat.
Religiosität	lat.
Relikten	lat.
Reliquien	lat.
Remanént	lat.
Remarkieren	frz.
Remboursieren	frz.
Remedium	lat.
Reminiszénz	lat.
Reminiszere	lat.
Remis	frz.
Remise	frz.
Remisier	frz.
Remission	lat.
Remitténden	lat.
Remíttens	lat.
Remittént	lat.
Remittieren	lat.
Remonetisieren	frz.
Remonstranten	lat.
Remonstrieren	lat.
Remonte	frz.
Remontieren	frz.
Remontoir	frz.
Remotion	lat.
Remoulade	frz.
Removieren	lat.
Remplaçant	frz.
Remuneration	lat.
Renaissance	frz.
Rencontre	frz.
Rendánt	frz.
Rendement	frz.
Rendezvous	frz.
Renegat	neulat.
Renforcé	frz.
Renifórm	neulat.
Renitént	lat.
Renommage	frz.
Renonce	frz.
Renovation	lat.
Renseignement	frz.
Rentabel	frz.
Rente	frz.
Rentier	frz.
Rentoilieren	frz.
Renunziation	lat.
Renvers	frz.
Reokkupation	lat.
Reorganisation	frz.
Repartieren	lat.
Repassieren	frz.
Repeal	engl.
Repertoire	frz.
Repertorium	lat.
Repetieren	lat.
Repetition	lat.
Repetitor	lat.
Repli	frz.
Reponieren	lat.
Report	engl.
Reposition	lat.
Repoussieren	frz.
Repräsentánt	lat.
Repräsentieren	lat.
Repressalien	lat.
Repression	lat.
Reprimánde	frz.
Reprimieren	lat.
Reprise	frz.
Reprobation	lat.
Reproduktion	lat.
Reproduzieren	lat.
Repúls	lat.
Repulsion	lat.
Reputation	lat.
Requête	frz.
Requiescat in pace	lat.
Requirieren	lat.
Res	lat.
Réseau	frz.
Resektion	lat.
Reservage	frz.
Reservat	lat.
Reservations	engl.
Reserve	frz.
Reservieren	lat.
Reservoir	frz.
Residént	lat.
Residénz	lat.
Residuum	lat.
Resignieren	lat.
Resistieren	lat.
Reskribieren	lat.
Resolut	lat.
Resolvieren	lat.
Resonánz	lat.
Resonator	neulat.
Resorbieren	lat.
Resorption	lat.
Respékt	lat.
Res pertinéntes	lat.
Respice finem	lat.
Respiration	lat.
Respirator	neulat.
Respirieren	lat.
Respondieren	lat.
Responsabel	lat.
Responsion	lat.
Responsorium	lat.
Res publica	lat.
Res severa (est) verum gaudium	lat.
Ressort	frz.
Ressource	frz.
Restánt	lat.
Restaurant	frz.
Restauration	lat.
Restieren	lat.
Restituieren	lat.
Restitutio in integrum	lat.
Restriktion	lat.
Resultánte	lat.
Resultat	lat.
Resümee	frz.
Resurrektion	lat.
Reszission	lat.
Retable	frz.
Retablieren	frz.
Retaliation	neulat.
Retard	frz.
Retardation	lat.
Rete	lat.
Retenieren	frz.
Retention	lat.
Retiarii	lat.
Reticulum	lat.
Retikular	lat.
Retina	lat.
Retirade	frz.
Retorsion	lat.
Retorte	frz.
Retour	frz.
Retournieren	frz.
Retrahént	lat.
Retraite	frz.
Retrákt	lat.
Retraktion	lat.
Retranchement	frz.
Retribution	lat.
Retriever	engl.
Retroflexion	lat.
Retuschieren	frz.
Rëunion	frz.
Reüssieren	frz.
Revakzination	neulat.
Revalidieren	neulat.
Revanche	frz.
Reveille	frz.
Revenons à nos moutons	frz.
Revenue	frz.
Reverberation	lat.
Reverénde	lat.
Reveréndus	lat.
Rêverie	frz.
Revérs	lat.
Reversieren	lat.
Revestiarium	neulat.
Revêtement	frz.
Revidieren	lat.
Review	engl.
Revindikation	neulat.
Revirement	frz.
Revision	lat.
Revisor	lat.
Revival	engl.
Revivifikation	lat.
Revokation	lat.
Revolte	frz.
Revolution	spätlat.
Revolver	engl.
Revozieren	lat.
Revue	frz.
Revulsion	lat.
Rex	lat.
Rezdechaussee	frz.
Rezensieren	lat.
Rezént	lat.
Rezepísse	lat.
Rezépt	lat.
Rezeptakulum	lat.
Rezeptitien	lat.
Rezéptor	lat.
Rezéß	lat.
Rezidiv	lat.
Rezipiént	lat.
Rezipieren	lat.
Reziprok	lat.
Rezitativ	ital.
Rezitieren	lat.
Rhabdomantie	grch.
Rhachitis	grch.
Rhagaden	grch.
Rhaphanie	grch.
Rhaphe	grch.
Rhapsoden	grch.
Rheochórd	grch.
Rheologie	grch.
Rheometer	grch.
Rheoskop	grch.
Rheostat	grch.
Rheotom	grch.
Rhetoren	grch.
Rhetorik	grch.
Rheuma	grch.
Rhinalgie	grch.
Rhineurynter	grch.
Rhiniatrik	grch.
Rhinoblennorrhöe	grch.
Rhinolith	grch.
Rhinologie	grch.
Rhinophyma	grch.
Rhombus	grch.
Rhonchus	grch.
Rhopalisch	grch.
Rhotazismus	grch.
Rhypia	grch.
Rhythmik	grch.
Rhythmus	grch.
Ricercata	ital.
Rideau	frz.
Ridéndo dicere verum	lat.
Rifle	engl.
Rigel	arab.
Rigid	lat.
Rigorismus	lat.
Rikambio	lat.
Rimborso	ital.
Rimesse	ital.
Ripieno	ital.
Riposte	frz.
Risalit	ital.
Risiko	ital.
Riskieren	frz.
Rissole	frz.
Ristorno	ital.
Ristretto	ital.
Ritardando	ital.
Rite	lat.
Ritenuto	ital.
Ritratte	ital.
Ritual	lat.
Ritus	lat.
Rival	frz.
Roastbeef	engl.
Robe	frz.
Robúst	lat.
Rocaille	frz.
Roche	pers.
Rochetum	neulat.
Rocks	engl.
Rocou	frz.
Rogate	lat.
Rogation	lat.
Roi	frz.
Roma locuta (est), causa finita (est)	lat.
Romancier	frz.
Romanismus	neulat.
Romanzero	span.
Rompen	holländ.
Roncesvalles	span.
Ronde	frz.
Rondeau	frz.
Rondel	frz.
Rondo	ital.
Rongerie	frz.
Roof	engl.
Roosbeen	holländ.
Rorate	lat.
Rosa	lat.
Rosarium	lat.
Roseola	lat.
Rosette	frz.
Rosieren	frz.
Rosso antico	ital.
Rostrum	lat.
Rotation	lat.
Rotatoren	lat.
Rotieren	lat.
Rotunde	lat.
Rotüre	frz.
Roucou	frz.
Roué	frz.
Rouge et noir	frz.
Rouille	frz.
Roulade	frz.
Rouleau	frz.
Roulette	frz.
Roulieren	frz.
Round Heads	engl.
Rout	engl.
Route	frz.
Routine	frz.
Rover	engl.
Rowdy	engl.
Royal	frz.
Rub	türk.
Rubato	ital.
Rubber	engl.
Rubrizelle	neulat.
Rubrum	lat.
Rudera	lat.
Rudimént	lat.
Ruin	lat.
Ruminantia	lat.
Rumpsteak	engl.
Run	engl.
Runlet	engl.
Runo	finn.
Ruptur	lat.
Rural	lat.
Rustika	ital.
Rustikal	lat.
Rustizität	lat.
Saccharifikation	neulat.
Saccharimetrie	grch.
Saccharum	lat.
Sacer morbus	lat.
Sachet	frz.
Sacraméntum	lat.
Sacré-Coeur	frz.
Sacrificium	lat.
Sacrifizio dell' intelletto	ital.
Sacrilegium	lat.
Sacristitium	lat.
Saeculares	lat.
Sadr	arab.
Safety-oil	engl.
Saga	altnord.
Sagazität	lat.
Sage-femme	frz.
Sagittarius	lat.
Sâhib	arab.
Saillant	frz.
Sainete	span.
Sainte ampoule	frz.
Saisieren	frz.
Saison	frz.
Sakkade	frz.
Sakral	lat.
Sakramént	lat.
Sakramentalen	lat.
Sakramentalien	lat.
Sakristan	mittellat.
Sakristei	mittellat.
Sakrosánkt	lat.
Säkular	lat.
Säkulum	lat.
Sakúska	russ.
Salade	frz.
Saladeros	span.
Salâm	arab.
Salami	ital.
Salamine	frz.
Saldo	ital.
Salem	arab.
Salicoques	frz.
Salière	frz.
Salifikation	neulat.
Saline	lat.
Saliva	lat.
Salix	lat.
Salmi	frz.
Salome	hebr.
Salon	frz.
Salpetrière	frz.
Salpinx	grch.
Salsen	ital.
Saltation	lat.
Salto	ital.
Salubrität	lat.
Salus	lat.
Salut	lat.
Salutatio ecclesiastica	lat.
Salvage	engl.
Salvation	lat.
Salvation Army	engl.
Salvator	lat.
Salvatorium	lat.
Salve regina	lat.
Salvieren	lat.
Salvis omissis	lat.
Salvo errore calculi	lat.
Salvus conductus	lat.
Sambuca	lat.
Samowár	russ.
Sanatorium	neulat.
Sancta simplicitas!	lat.
Sanctitas	lat.
Sanctum officium	lat.
Sanctus	lat.
Sandale	grch.
Sandschaktar	türk.
Sandwiches	engl.
Sanfedisten	ital.
Sanguiniker	lat.
Sanguinoles	frz.
Sanguisuga	lat.
Sanieren	lat.
Sanies	lat.
Sanität	lat.
Sankt	lat.
Sanktifizieren	lat.
Sanktion	lat.
Sanktissimum	lat.
Sanktuarium	mittellat.
Sans	frz.
Sansculotten	frz.
Sanssouci	frz.
Santa	ital.
Santa conversazione	ital.
São	portug.
Saône	frz.
Sapere aude	lat.
Sapienti sat	lat.
Saponifikation	neulat.
Sappe	frz.
Saprämie	grch.
Saprogen	grch.
Sarafán	russ.
Sarkásmus	grch.
Sarkolemma	grch.
Sarkom	grch.
Sarkophag	grch.
Satan	hebr.
Satellit	lat.
Satin	frz.
Satinieren	frz.
Satisfaktion	lat.
Saturation	lat.
Saturieren	lat.
Satyriasis	grch.
Sauf-conduit	frz.
Saul	hebr.
Säule	kristallogr.
Sautieren	frz.
Sauve qui peut!	spr.
Savannen	span.
Sävitien	lat.
Savoir-faire	frz.
Savonette	frz.
Sbornik	russ.
Scabies	lat.
Scapula	lat.
Scarabaeus	lat.
Schabbes	hebr.
Schabrácke	türk.
Schacharit	hebr.
Schâh	pers.
Schahsade	pers.
Schassieren	frz.
Schelk	zoolog.
Scheltopusik	russ.
Schema	grch.
Schemen	grch.
Scheol	hebr.
Scherîf	arab.
Scherzando	ital.
Scherzo	ital.
Schibboleth	hebr.
Schiffsboot	zoolog.
Schîiten	arab.
Schill	zoolog.
Schisma	grch.
Schneider	zoolog.
Schochet	hebr.
Schola	lat.
Scholárch	grch.
Scholastikus	lat.
Scholien	grch.
Schott	arab.
Schrecken	zoolog.
Schtschi	russ.
Schulchan aruch	hebr.
Schuld	jurist.
Scilicet	lat.
Sciolto	ital.
Scolex	lat.
Sconto	ital.
Scriptum	lat.
Scrotum	lat.
Scudo	ital.
Sculpsit	lat.
Seal	engl.
Sealskin	engl.
Séance	frz.
Season	engl.
Seborrhöe	grch.
Secco	ital.
Seceders	engl.
Sectio aurea	lat.
Section	engl.
Sedes	lat.
Sedez	lat.
Sedimént	lat.
Sedisvakánz	lat.
Sedition	lat.
Sedulität	lat.
Seduzieren	lat.
Segmént	lat.
Segno	ital.
Segregieren	lat.
Seiches	frz.
Seigneur	frz.
Seisachthie	grch.
Sekante	lat.
Sekludieren	lat.
Sekret	lat.
Sekrete	lat.
Sekretion	lat.
Sekten	lat.
Sektion	lat.
Sektor	lat.
Sekunda	lat.
Sekundánt	lat.
Sekundär	lat.
Sekunde	lat.
Sekundieren	lat.
Sekundiz	lat.
Sekundogenitur	lat.
Sekurität	lat.
Séla	hebr.
Seladon	span.
Sel d'or	frz.
Selekta	lat.
Selektion	lat.
Seleniten	grch.
Selenodónten	grch.
Selenographie	grch.
Sélfaktor	engl.
Selfgovernment	engl.
Self-made man	engl.
Semántik	grch.
Semaphor	grch.
Semasiologie	grch.
Semeiographie	grch.
Semen	lat.
Seméster	lat.
Semi	lat.
Semi-brevis	lat.
Seminar	lat.
Semivocales	lat.
Semper	lat.
Semskij Sobor	russ.
Senar	lat.
Senatus consultum	lat.
Seneszénz	lat.
Senhor	portug.
Senil	lat.
Senior	lat.
Seniorat	lat.
Sensal	ital.
Sensation	neulat.
Sensibel	lat.
Sensorium	neulat.
Sensual	lat.
Sensus	lat.
Senténz	lat.
Sentiment	frz.
Sentimental	lat.
Sepala	lat.
Separabel	lat.
Separation	lat.
Separatísmus	lat.
Separator	lat.
Separieren	lat.
Sephardim	hebr.
Sepsis	grch.
Septémvir	lat.
Septennal	lat.
Septentrional	lat.
Septime	lat.
Septisch	grch.
Septuagesima	lat.
Septuaginta	lat.
Sepulkral	lat.
Séquens	lat.
Sequénz	lat.
Sequéster	lat.
Sequestration	lat.
Séracs	frz.
Serail	frz.
Seraskier	türk.
Serenissimus	lat.
Serenität	lat.
Serge	frz.
Seriba	arab.
Serimeter	grch.
Serinette	frz.
Sermon	lat.
Serös	lat.
Serpent	frz.
Serpentinen	lat.
Serra	portug.
Serum	lat.
Servante	frz.
Servator	lat.
Service	frz.
Servieren	lat.
Servil	lat.
Serviteur	frz.
Servitut	lat.
Servus	lat.
Sessilität	spätlat.
Session	lat.
Sestine	ital.
Setier	frz.
Sette Comuni	ital.
Settlement	engl.
Sever	lat.
Sevum	lat.
Sewage	engl.
Sewrúga	russ.
Sexagesima	lat.
Sexennium	lat.
Sexta	lat.
Sextánt	lat.
Sexte	lat.
Sextett	lat.
Sextum	lat.
Sexual	lat.
Sezernieren	lat.
Sezession	lat.
Sezieren	lat.
Sfumato	ital.
Shad	engl.
Shampoo	engl.
Shamrock	engl.
Shapingmaschine	engl.
Share	engl.
Sherry	engl.
Shock	engl.
Shocking	engl.
Shoddy	engl.
Shorthand	engl.
Sialorrhöe	grch.
Sibilanten	lat.
Sic	lat.
Sic transit gloria mundi	lat.
Sic volo, sic jubeo etc.	lat.
Sideral	lat.
Siderísmus	grch.
Siderosis	grch.
Siderostat	grch.
Sidra	aram.
Sierra	span.
Siesta	span.
Sieur	frz.
Si fecisti nega	lat.
Sigillum	lat.
Signal	lat.
Signalement	frz.
Signalisieren	lat.
Signatär	frz.
Signatur	lat.
Signet	lat.
Signieren	lat.
Signifizieren	lat.
Signore	ital.
Signoria	ital.
Signum	lat.
Signum laudis	lat.
Sikkative	lat.
Sikuler	lat.
Silentium	lat.
Silicispongiae	lat.
Siliqua	lat.
Silk	engl.
Sill	engl.
Sillabub	engl.
Sillograph	grch.
Silo	span.
Sima	grch.
Simchat Thora	hebr.
Simia	lat.
Similia similibus	lat.
Simplex	lat.
Simplizität	lat.
Simplum	lat.
Simulation	lat.
Simultan	lat.
Sincere et constanter	lat.
Sindaco	ital.
Sindon	grch.
Sine ira et studio	lat.
Sine loco et anno	lat.
Sinfonie	ital.
Singleton	engl.
Singultus	lat.
Sinistra mano	ital.
Sinking fund	engl.
Sinolog	grch.
Sint, ut sunt, aut non sint	lat.
Sinus	lat.
Sipahi	pers.
Si parva licet componere magnis	lat.
Siphon	grch.
Sir	engl.
Sire	frz.
Siriasis	grch.
Sistieren	lat.
Si tacuisses, philosophus mansisses	lat.
Sitometer	grch.
Sitophobie	grch.
Situation	lat.
Situieren	lat.
Situla	lat.
Sit venia verbo	lat.
Si vis pacem, para bellum	lat.
Sjetsch	russ.
Skabiös	lat.
Skabrös	lat.
Skalenoeder	grch.
Skalp	engl.
Skalpéll	lat.
Skandal	grch.
Skandieren	lat.
Skarifikation	lat.
Skating-Rink	engl.
Skatophagie	grch.
Skazon	grch.
Skelétt	grch.
Skepsis	grch.
Skeptizismus	grch.
Ski	norweg.
Skiaskopie	grch.
Skiff	engl.
Skioptikon	grch.
Sklerenchym	grch.
Skleritis	grch.
Sklerometer	grch.
Skolex	grch.
Skolien	grch.
Skoliose	grch.
Skopzen	russ.
Skotom	grch.
Skrubber	engl.
Skrupel	lat.
Skulptur	lat.
Skupschtina	serb.
Skutifórm	lat.
Sky-scrapers	engl.
Skytale	grch.
Slang	engl.
Smart	engl.
Smoking	engl.
Smorzando	ital.
Snob	engl.
Soapstone	engl.
Sobor	russ.
Sobrietät	lat.
Soccus	lat.
Societas	lat.
Société anonyme	frz.
Sur	frz.
Soferim	hebr.
Soffionen	ital.
Soffite	ital.
Soi-disant	frz.
Soirée	frz.
Sokol	slaw.
Solamen miseris socios habuisse malorum	lat.
Solano	span.
Solar	lat.
Soldateska	ital.
Soldo	ital.
Solénn	lat.
Solfatara	ital.
Solfeggio	ital.
Solicitor	engl.
Solid	lat.
Soli Deo gloria!	lat.
Solidität	lat.
Soliloquium	lat.
Solipeden	lat.
Solíst	ital.
Solitär	lat.
Solitude	frz.
Sollizitieren	lat.
Solo	ital.
Solözísmus	grch.
Solstitien	lat.
Solution	lat.
Solvént	lat.
Solvieren	lat.
Somatisch	grch.
Sombreros	span.
Sommation	frz.
Sommitäten	frz.
Somnifera	lat.
Somnus	lat.
Sonánt	lat.
Sonate	ital.
Sonétt	ital.
Sonor	lat.
Sophia	grch.
Sophisma	grch.
Sophroníst	grch.
Sophrosyne	grch.
Sopka	russ.
Sopor	lat.
Sopran	ital.
Sopratara	ital.
Sordino	ital.
Soredien	grch.
Sorites	grch.
Soroche	span.
Sortie	frz.
Sortimént	ital.
Sostenuto	ital.
Soter	grch.
Sotie	frz.
Sottise	frz.
Sotto voce	ital.
Soubrette	frz.
Souche	frz.
Souffleur	frz.
Soufrière	frz.
Soulagieren	frz.
Souper	frz.
Sourdine	frz.
Soutache	frz.
Soutane	frz.
Soutenieren	frz.
Souterrain	frz.
Soutien	frz.
Souvenir	frz.
Souverain	frz.
Soziabel	lat.
Sozial	lat.
Sozialismus	lat.
Sozietät	lat.
Sozius	lat.
Spadille	frz.
Spagyrie	grch.
Spaniel	engl.
Spanish Stripes	engl.
Sparadrap	frz.
Sparterie	frz.
Spatha	lat.
Spatium	lat.
Speaker	engl.
Species	lat.
Specifica	lat.
Spedition	ital.
Speech	engl.
Spektabel	lat.
Spektrum	lat.
Spekulation	lat.
Speläologie	grch.
Spelter	engl.
Spelunke	lat.
Spendieren	ital.
Sperma	grch.
Spermatitis	grch.
Spermatophoren	grch.
Spermatorrhöe	grch.
Spesen	ital.
Spezifikation	lat.
Spezifisch	lat.
Spezifizieren	lat.
Spezimen	lat.
Speziös	lat.
Spezzia	ital.
Sphäre	grch.
Sphäroid	grch.
Sphärolithe	grch.
Sphärologie	grch.
Sphärometer	grch.
Sphen	grch.
Sphinkter	grch.
Sphragístik	grch.
Sphygmisch	grch.
Spina	lat.
Spinös	lat.
Spintherismus	grch.
Spintrien	lat.
Spion	ital.
Spirabel	lat.
Spiránt	lat.
Spiritismus	neulat.
Spiritualen	lat.
Spiritualismus	lat.
Spiritualität	lat.
Spirituös	lat.
Spiritus	lat.
Spiritus familiaris	lat.
Spiritus rector	lat.
Spizilegium	lat.
Splanchna	grch.
Spleen	engl.
Splen	grch.
Splendid	lat.
Spodium	grch.
Spoliation	lat.
Spolium	lat.
Sponde	lat.
Spondeus	grch.
Spondylus	grch.
Spongiös	lat.
Sponsalien	lat.
Spontan	lat.
Sporaden	grch.
Sporadisch	grch.
Sporangium	grch.
Sporco	ital.
Sporen	grch.
Sporogonium	grch.
Sport	engl.
Sporteln	lat.
Sposalizio	ital.
Spray	engl.
Sputum	lat.
Squama	lat.
Square	engl.
Squire	engl.
Stabat mater	lat.
Stabil	lat.
Stabilität	lat.
Staccato	ital.
Stadion	grch.
Stafette	frz.
Staffage	frz.
Staffel	militär.
Stagione	ital.
Stagnation	lat.
Stagnieren	lat.
Stamen	lat.
Stamp	engl.
Standard	engl.
Staníza	russ.
Stannum	lat.
Stante pede	lat.
Stanze	ital.
Staphylitis	grch.
Staphylom	grch.
Star	engl.
Stárosta	slaw.
Starowjerzy	russ.
Start	engl.
Stasimon	grch.
Statarisch	lat.
Stathmograph	grch.
Statik	grch.
Station	lat.
Statisch	grch.
Statíst	neulat.
Stativ	lat.
Statuarisch	lat.
Statue	lat.
Statuétte	frz.
Statuieren	lat.
Statur	lat.
Status	lat.
Statut	lat.
Steamer	engl.
Steatom	grch.
Steatopygie	grch.
Steatose	grch.
Steeplechase	engl.
Stegnosis	grch.
Stele	grch.
Stemma	grch.
Stenochromie	grch.
Stenográmm	grch.
Stenograph	grch.
Stenographie	grch.
Stenokardie	grch.
Stenopäisch	grch.
Stenose	grch.
Stenotachygraphie	grch.
Stenotelegraph	grch.
Stenotypie	grch.
Stentándo	ital.
Stephanoskop	grch.
Stère	frz.
Stereochemie	grch.
Stereochromie	grch.
Stereometer	grch.
Stereometrie	grch.
Stereoskop	grch.
Stereotomie	grch.
Stereotyp	grch.
Stereotypie	grch.
Steril	lat.
Sterkorieren	lat.
Sternalgie	grch.
Sternum	lat.
Sternutation	lat.
Stethograph	grch.
Stethoskop	grch.
Steward	engl.
Sthenie	grch.
Stibium	lat.
Stichomantie	grch.
Stichometrie	grch.
Stigma	grch.
Stigmatypie	grch.
Stilétt	ital.
Stimulieren	lat.
Stipendium	lat.
Stipes	lat.
Stipulation	lat.
Stoa	grch.
Stöchiometrie	grch.
Stock	engl.
Stock-exchange	engl.
Stockjobber	engl.
Stoma	grch.
Stomachal	lat.
Stomatika	grch.
Stomatoskop	grch.
Stone	engl.
Stonehenge	engl.
Stop	engl.
Stoppine	ital.
Store	engl.
Store	frz.
Stornieren	ital.
Strabismus	grch.
Strabotomie	grch.
Strafabteilungen	militär.
Stralcio	ital.
Strangulation	lat.
Strangurie	grch.
Strapaze	ital.
Strashnik	russ.
Strateg	grch.
Strategie	grch.
Stratifikation	neulat.
Stratiot	grch.
Stratus	lat.
Strenuität	lat.
Strepitoso	ital.
Stretta	ital.
Stricte	lat.
Stride	engl.
Stridor	lat.
Strike	engl.
Striktur	lat.
Stringendo	ital.
Stringieren	lat.
Stroboskop	grch.
Stroma	grch.
Stromatik	grch.
Strophe	grch.
Strophulus	lat.
Struggle for life	engl.
Struktur	lat.
Struma	lat.
Strusi	ital.
Studieren	lat.
Studio	ital.
Stupefaktion	lat.
Stupid	lat.
Stupor	lat.
Stuprum	lat.
Styliten	grch.
Stylobat	grch.
Stylolithen	grch.
Styptika	grch.
Su	türk.
Suasorisch	lat.
Sua sponte	lat.
Subaltérn	lat.
Sub conditione	lat.
Subdelegieren	lat.
Subdivision	lat.
Subdominus	lat.
Subfebril	lat.
Subhastation	lat.
Subjekt	lat.
Sub Jove	lat.
Sub judice	lat.
Subjunktiv	lat.
Subkutan	lat.
Sublim	lat.
Sublimat	lat.
Sublimation	lat.
Sublunarisch	lat.
Subluxation	lat.
Submarin	lat.
Submergieren	lat.
Subministrieren	lat.
Submíß	lat.
Subordinieren	lat.
Subreption	lat.
Sub rosa	lat.
Subsellien	lat.
Subsequens	lat.
Subsidium	lat.
Sub sigillo	lat.
Subsignieren	lat.
Subsistieren	lat.
Subskribieren	lat.
Substantivum	lat.
Substánz	lat.
Substituieren	lat.
Substrat	lat.
Substruktion	lat.
Subsumieren	lat.
Subtil	lat.
Subtrahieren	lat.
Sub utraque specie	lat.
Subvenieren	lat.
Subversion	lat.
Sub voce	lat.
Sub voto remissionis	lat.
Succès d'estime	frz.
Sudation	lat.
Suffisance	frz.
Suffiziént	lat.
Suffrage universel	frz.
Suffragium	lat.
Suffusion	lat.
Suggerieren	lat.
Suggestibilität	neulat.
Suggestion	lat.
Sugillation	lat.
Sui juris	lat.
Suite	frz.
Sujet	frz.
Sukkade	ital.
Sukkulént	lat.
Sukkumbénz	lat.
Sukkurrieren	lat.
Sukzedieren	lat.
Sulamith	hebr.
Sultân	arab.
Summa	lat.
Summarisch	lat.
Summarium	lat.
Summepiskopat	lat.
Summum bonum	lat.
Summus episcopus	lat.
Sunna	arab.
Suovetaurilia	lat.
Superarbitrium	lat.
Supérb	lat.
Superfizies	lat.
Superfötation	lat.
Superintendent	lat.
Superior	lat.
Superlativ	lat.
Supernumerarius	neulat.
Superrevision	neulat.
Superstition	lat.
Supination	lat.
Suppeditieren	lat.
Suppléant	frz.
Supplemént	lat.
Supplént	lat.
Suppletorisch	lat.
Supplieren	lat.
Supplikationen	lat.
Supplizieren	lat.
Supponieren	lat.
Support	frz.
Supposition	lat.
Suppositorien	lat.
Suppression	lat.
Supralapsarier	neulat.
Supranaturalismus	neulat.
Supremat	lat.
Surah	frz.
Surcot	frz.
Surdität	lat.
Surplus	frz.
Surre	arab.
Surrogat	lat.
Sursum corda	lat.
Surtout	frz.
Sus	lat.
Suspékt	lat.
Suspendieren	lat.
Suspensorium	lat.
Suspizion	lat.
Suum cuique	lat.
Suzeränität	frz.
Sverige	schwed.
Swamps	engl.
Swandown	engl.
Swanskin	engl.
Sweatingsystem	engl.
Sweepstakes	engl.
Swell	engl.
Sycosis	grch.
Sykophánt	grch.
Syllabarium	neulat.
Syllabus	grch.
Syllepsis	grch.
Syllogismus	grch.
Sylphen	grch.
Symbiose	grch.
Symbolik	grch.
Symmachie	grch.
Symmelie	grch.
Symmetrie	grch.
Sympathetisch	grch.
Sympathicus nervus	lat.
Sympathie	grch.
Sympathisieren	frz.
Symphonie	grch.
Sympiëzometer	grch.
Symplegaden	grch.
Sympodie	grch.
Symptom	grch.
Sympus	grch.
Synagoge	grch.
Synaphie	grch.
Synarthrosis	grch.
Synästhesie	grch.
Synchronísmus	grch.
Syndésmus	grch.
Syndikus	grch.
Synechie	grch.
Synedrium	grch.
Synekdoche	grch.
Synergiden	grch.
Synergismus	grch.
Synesis	grch.
Synizesis	grch.
Synkarpium	grch.
Synklinale	grch.
Synkópe	grch.
Synkrasis	grch.
Synkratie	grch.
Synkretismus	grch.
Synode	grch.
Synoditen	grch.
Synonym	grch.
Synopsie	grch.
Synópsis	grch.
Synóptisch	grch.
Synovia	grch.
Syntágma	grch.
Syntáktisch	grch.
Syntax	grch.
Syphilis	grch.
Syriasis	grch.
System	grch.
Systematik	grch.
Systole	grch.
Syzygie	grch.
Szene	lat.
Szent	ungar.
Szintillieren	lat.
Szirrhus	grch.
Szissalien	lat.
Szissibel	lat.
Tabagie	frz.
Tabatiere	frz.
Tabelle	lat.
Taberna	lat.
Tabes	lat.
Tableau	frz.
Table d'hôte	frz.
Tablétt	frz.
Tablette	frz.
Tabletterie	frz.
Tabouret	frz.
Tabula	lat.
Tabúlett	lat.
Tachygraph	grch.
Tachykardie	grch.
Tahâret	arab.
Taillanderie	frz.
Taille	frz.
Taille-douce	frz.
Tailleur	frz.
Taillon	frz.
Takt	lat.
Táktik	grch.
Talar	lat.
Talént	grch.
Talion	lat.
Talisman	arab.
Talmud	neuhebr.
Talon	frz.
Talus	frz.
Talus	lat.
Tambour	frz.
Tambur	türk.
Tamis	frz.
Tammus	hebr.
Tampon	frz.
Tandem	engl.
Tangénte	lat.
Tangieren	lat.
Tanks	engl.
Tannaim	hebr.
Tansímât	arab.
Tantieme	frz.
Tape	engl.
Tapisserie	frz.
Tapotement	frz.
Tara	ital.
Tarantás	russ.
Tardando	ital.
Tardieren	lat.
Targum	hebr.
Tarif	arab.
Tarlatan	frz.
Tarotiert	frz.
Tarsus	grch.
Tartane	ital.
Tasajo	span.
Tasch	türk.
Tassajo	span.
Tasto solo	ital.
Tatarka	poln.
Tauromachie	grch.
Tautochrone	grch.
Tautográmm	grch.
Tautologie	grch.
Tautomerie	grch.
Taxidermie	grch.
Téchnik	grch.
Technologie	grch.
Technopägnia	grch.
Teetotaler	engl.
Tefilla	hebr.
Tefillim	hebr.
Teffîr	arab.
Tegumént	lat.
Teint	frz.
Tektologie	grch.
Tektonik	grch.
Tektur	lat.
Telamon	grch.
Telega	russ.
Telegraphie	grch.
Teleologie	grch.
Telepathie	grch.
Telephon	grch.
Teleskop	grch.
Teleutosporen	grch.
Tellurium	lat.
Temperamént	lat.
Temperatur	lat.
Temperieren	lat.
Tempesta	ital.
Tempi passati	ital.
Tempo	ital.
Tempora	lat.
Temporalien	lat.
Temporär	lat.
Temporisieren	frz.
Tempus	lat.
Tenaille	frz.
Tenalgie	grch.
Tenazität	lat.
Tendénz	lat.
Tender	engl.
Tendieren	lat.
Tenésmus	grch.
Tenor	lat.
Tenor	ital.
Tenorrhaphie	grch.
Tenosynitis	grch.
Tension	lat.
Tenson	frz.
Tentamen	lat.
Tente d'abri	frz.
Tenue	frz.
Tenuis	lat.
Tenuto	ital.
Tenzone	ital.
Tepache	span.
Tepe	türk.
Tephillin	hebr.
Tepidarium	lat.
Tera	japan.
Teratogenie	grch.
Teratologie	grch.
Teratom	grch.
Teratoskopie	grch.
Tergiversieren	lat.
Termin	lat.
Terminieren	lat.
Terminus	lat.
Terne	lat.
Terra	lat.
Terra di Siena	ital.
Terrain	frz.
Terra japonica	lat.
Terrakotta	ital.
Terramaren	ital.
Terrarium	lat.
Terra rossa	ital.
Terra sigillata	lat.
Terrásse	frz.
Terrazzo	ital.
Terres-fortes	frz.
Terréstrisch	lat.
Terreur	frz.
Terribel	lat.
Terrine	frz.
Territion	lat.
Territorial	lat.
Territorium	lat.
Terrorísmus	neulat.
Tertia	lat.
Tertian	lat.
Tertie	lat.
Tertiogenitur	neulat.
Tertium	lat.
Tertius gaudet	lat.
Terz	lat.
Terzerol	ital.
Terzétt	ital.
Testa	lat.
Testamént	lat.
Testamentarisch	lat.
Testat	lat.
Testator	lat.
Testieren	lat.
Testifizieren	lat.
Testikeln	lat.
Testimonium	lat.
Testudo	lat.
Tetanus	grch.
Tetartoëdrie	grch.
Tete	frz.
Tetrachórd	grch.
Tetraeder	grch.
Tetragon	grch.
Tetragynisch	grch.
Tetralogie	grch.
Tetrameter	grch.
Tetrandrisch	grch.
Tetrapodie	grch.
Tetrárch	grch.
Text	lat.
Textil	lat.
Textur	lat.
Thalamus	grch.
Thalassographie	grch.
Thalassotherapie	grch.
Thallophyten	grch.
Thallus	grch.
Thalysia	grch.
Thanksgiving-day	engl.
Thaumatologie	grch.
Thaumatrop	grch.
Thaumaturg	grch.
Theater	grch.
Theatralisch	grch.
Theatrum anatomicum	lat.
Thé dansant	frz.
Theïsmus	grch.
Thekodónt	grch.
Thema	grch.
Theodizee	grch.
Theognosie	grch.
Theokratie	grch.
Theolatrie	grch.
Theologie	grch.
Theomantie	grch.
Theophanie	grch.
Theopneustie	grch.
Theopsie	grch.
Theorem	grch.
Theorie	grch.
Theosophie	grch.
Theoxenien	grch.
Therapeutisch	grch.
Theresia von Jesu	span.
Theriak	grch.
Thermen	grch.
Thermidor	frz.
Thérmik	grch.
Thermocautère	frz.
Thermodynamik	grch.
Thermoelektrizität	grch.
Thermograph	grch.
Thermohypsometer	grch.
Thermokaustik	grch.
Thermokauter	grch.
Thermolyse	grch.
Thermometer	grch.
Thermometrie	grch.
Thermophon	grch.
Thermoskop	grch.
Thermostat	grch.
Thermotherapie	grch.
Thesaurarius	mittellat.
Thesaurus	grch.
Thesmophorien	grch.
Thesmotheten	grch.
Thëurgie	grch.
Thora	hebr.
Thorax	grch.
Thrombose	grch.
Thyreoidektomie	grch.
Thyreoiditis	grch.
Thyreotomie	grch.
Thyrsus	grch.
Tiara	grch.
Tibia	lat.
Tic	frz.
Ticket	engl.
Tiden	niederd.
Tiers-argent	frz.
Tiers-état	frz.
Tiers-parti	frz.
Tieuté	frz.
Tilbury	engl.
Tilde	span.
Tilia	lat.
Timbale	frz.
Timbre	frz.
Time is money	engl.
Timid	lat.
Timokratie	grch.
Timpano	ital.
Tinea	lat.
Tingieren	lat.
Tinktur	lat.
Tinte	ital.
Tinte	mittellat.
Tiorba	ital.
Tip	engl.
Tiqueur	frz.
Tirade	frz.
Tirailleure	frz.
Tirassieren	frz.
Tirefond	frz.
Tiro	lat.
Tirolienne	frz.
Tisane	frz.
Tisza	ungar.
Titanomachie	grch.
Titular	lat.
Titulaturen	neulat.
Tmesis	grch.
Toast	engl.
Tockieren	ital.
Toddy	engl.
Tohuwabohu	hebr.
Toilette	frz.
Toison d'or	frz.
Tokadille	span.
Tokkata	ital.
Tolerabel	lat.
Tombola	ital.
Ton	physik.
Tonica	grch.
Tonika	ital.
Tonisch	grch.
Tonnage	frz.
Tonneau	frz.
Ton of Shipping	engl.
Tonsillen	lat.
Tonsur	lat.
Tonus	grch.
Top-Hane	türk.
Topik	grch.
Topisch	grch.
Topograph	grch.
Topographie	grch.
Topologie	grch.
Toponomástik	grch.
Top-weight	engl.
Toque	frz.
Toraillen	frz.
Toreador	span.
Torero	span.
Toreutik	grch.
Tornado	span.
Torneutik	grch.
Torpedo	lat.
Torpid	lat.
Torrefaktion	lat.
Torsion	lat.
Torso	ital.
Tortur	lat.
Torus	lat.
Total	lat.
Totenlade	mediz.
Toujours en vedette	frz.
Toujours perdrix	frz.
Toupet	frz.
Tour	frz.
Tourbillon	frz.
Touríst	engl.
Tournée	frz.
Tournesol	frz.
Tournieren	frz.
Tourniquet	frz.
Tout va	frz.
Tower	engl.
Town	engl.
Toxikologie	grch.
Trabakel	ital.
Trace	frz.
Tracee	frz.
Trachea	grch.
Tracheen	grch.
Tracheitis	grch.
Tracheobronchitis	grch.
Tracheotomie	grch.
Trachom	grch.
Tradition	lat.
Traditionell	frz.
Tragelaph	grch.
Tragik	grch.
Tragikomisch	grch.
Tragisch	grch.
Tragödie	grch.
Traille	frz.
Train	frz.
Trainieren	engl.
Traiteur	frz.
Trajékt	lat.
Trajektorie	neulat.
Trakasserie	frz.
Trakt	lat.
Traktabel	lat.
Traktamént	neulat.
Traktat	lat.
Traktieren	lat.
Traktorie	neulat.
Tralje	holländ.
Trama	ital.
Tramelogödie	grch.
Tramontana	ital.
Trampoline	ital.
Tramway	engl.
Trance	engl.
Tranchee	frz.
Tranchieren	frz.
Transaktion	lat.
Transalpinisch	lat.
Transatlántisch	lat.
Transdanubisch	lat.
Transépt	lat.
Transferieren	lat.
Transfiguration	lat.
Transformation	lat.
Transfundieren	lat.
Transgression	lat.
Transigieren	lat.
Transition	lat.
Transitorisch	lat.
Transkribieren	lat.
Translation	lat.
Translozieren	lat.
Transmarin	lat.
Transmigration	lat.
Transmission	lat.
Transmittieren	lat.
Transmontan	lat.
Transmutieren	lat.
Transpadanisch	lat.
Transparént	neulat.
Transpiration	neulat.
Transplantation	lat.
Transponieren	lat.
Transpórt	lat.
Transportation	lat.
Transporteur	frz.
Transportieren	lat.
Transrhenanisch	lat.
Transsubstantiation	neulat.
Transsudation	lat.
Transversal	lat.
Transzendént	lat.
Trapez	grch.
Trapezoeder	grch.
Trappers	engl.
Trassieren	ital.
Trattorie	ital.
Traulismus	grch.
Trauma	grch.
Travaux forcés	frz.
Travers	frz.
Traverse	frz.
Trawl	engl.
Treasure	engl.
Trema	grch.
Trembles	engl.
Tremolando	ital.
Tremplin	frz.
Trente-et-quarante	frz.
Trente-et-un	frz.
Trephine	frz.
Tres faciunt collegium	lat.
Tresor	frz.
Treuga Dei	lat.
Triage	frz.
Triakontere	grch.
Triandrisch	grch.
Triangel	lat.
Triangulation	neulat.
Triangulum	lat.
Triarchie	grch.
Trias	grch.
Tribadie	grch.
Tribometer	grch.
Tribrachys	grch.
Tribulieren	lat.
Tribunal	lat.
Tribunat	lat.
Tribüne	frz.
Tribut	lat.
Trichiasis	grch.
Trichomykose	grch.
Trichórd	grch.
Trichosen	grch.
Trichroïsmus	grch.
Trick	engl.
Tricolor	lat.
Tricycle	engl.
Triduum	lat.
Triënnium	lat.
Triere	grch.
Triëteris	grch.
Trieur	frz.
Trifolium	lat.
Triforium	mittellat.
Triga	lat.
Trigemini	lat.
Triglaw	slaw.
Triglotte	grch.
Triglyph	grch.
Trigon	grch.
Trigonometrie	grch.
Trigynisch	grch.
Trikolore	frz.
Trikot	frz.
Trilateral	lat.
Trilinguisch	lat.
Trilogie	grch.
Triméster	lat.
Trimeter	grch.
Trinität	lat.
Trinomisch	grch.
Trio	ital.
Triole	ital.
Triolétt	frz.
Tripartition	lat.
Triplik	lat.
Triplizität	lat.
Triplum	lat.
Tripode	grch.
Tripotage	frz.
Tripsis	grch.
Triptychon	grch.
Tripus	grch.
Triquetra	lat.
Triquetrum	lat.
Trireme	lat.
Trisektion	lat.
Trismus	grch.
Trispást	grch.
Trist	lat.
Tristichon	grch.
Trisyllabisch	grch.
Triumph	lat.
Trivium	lat.
Trochanter	grch.
Trochäus	grch.
Trochisken	grch.
Troglodyten	grch.
Tromba	ital.
Trombe	ital.
Trombone	ital.
Troparion	grch.
Tropen	grch.
Trophologie	grch.
Trophoneurose	grch.
Trottoir	frz.
Troupier	frz.
Trousseau	frz.
Trumeau	frz.
Trunk Lines	engl.
Trust	engl.
Trustee	engl.
Tschamara	tschech.
Tscheri	türk.
Tschernosem	russ.
Tschin	russ.
Tschinównik	russ.
Tuba	lat.
Tubérkeln	lat.
Tubulus	lat.
Tubus	lat.
Tumor	lat.
Tundra	russ.
Tunicella	lat.
Tunnel	engl.
Turbation	lat.
Turbulént	lat.
Turf	engl.
Turgeszénz	lat.
Turgor	lat.
Turnüre	frz.
Turnus	neulat.
Tuschieren	frz.
Tutor	lat.
Tutor	engl.
Tutti	ital.
Tutti frutti	ital.
Tweed	engl.
Tympanitis	grch.
Tympanum	grch.
Typhlitis	grch.
Typhlosis	grch.
Typhoid	grch.
Typhon	engl.
Typhus	grch.
Typikon	grch.
Typograph	grch.
Typolithographie	grch.
Typometer	grch.
Typoskop	grch.
Typus	grch.
Tyránn	grch.
Tyrotoxikon	grch.
Ubertät	lat.
Ubikation	neulat.
Ubiquität	kirchenlat.
Uitlanders	holländ.
Ujesd	russ.
Ukás	russ.
Ulanen	poln.
Ulcus	lat.
Ulemâ	arab.
Ulmus	lat.
Ulna	lat.
Ulster	engl.
Ultima ratio regum	lat.
Ultima Thule	lat.
Ultimatum	lat.
Ultimus	lat.
Ultra	lat.
Ultramontan	lat.
Ultra posse nemo obligatur	lat.
Ulzeration	lat.
Umbilicus	lat.
Umbra	lat.
Unam sanctam	lat.
Unanimität	lat.
Uncia	lat.
Uncle Sam	engl.
Undation	lat.
Undergraduate	engl.
Undulation	lat.
Unfair	engl.
Ungehorsam	jurist.
Unguéntum	lat.
Ungulata	lat.
Uni	frz.
Uniaten	lat.
Unieren	lat.
Unifizieren	neulat.
Uniform	lat.
Uniformismus	neulat.
Uniformität	lat.
Unigenitus Dei filius	lat.
Unikum	lat.
Union	lat.
Union Jack	engl.
Union latine	frz.
Unio prolium	lat.
Unisono	ital.
Unitarier	neulat.
Unität	lat.
Unitis viribus	lat.
Universal	lat.
Universalismus	neulat.
Universalität	lat.
Universéll	frz.
University extension movement	engl.
Univérsum	lat.
Univok	lat.
Unktion	lat.
Un poco	ital.
Unus pro multis	lat.
Urämie	grch.
Urania	grch.
Uranographie	grch.
Uranolatrie	grch.
Uranolithen	grch.
Uranologie	grch.
Uranometrie	grch.
Uranoplástik	grch.
Uranos	grch.
Urat	grch.
Urban	lat.
Urbi et orbi	lat.
Urbs	lat.
Ureter	grch.
Urethra	grch.
Urf	arab.
Urgént	lat.
Urgieren	lat.
Uriel	hebr.
Urim und Thummim	hebr.
Urin	lat.
Urnen	lat.
Urocele	grch.
Urolithiasis	grch.
Urologie	grch.
Uropoetisch	grch.
Uroskopie	grch.
Ursa major	lat.
Urticaria	lat.
Urtikation	lat.
Usance	frz.
Uso	ital.
Ustaw	russ.
Usucapio	lat.
Usuell	frz.
Usufruktuar	lat.
Usur	lat.
Usurpation	lat.
Usus	lat.
Ususfruktus	lat.
Ut desint vires, tamen est laudanda voluntas	lat.
Utensilien	lat.
Uterus	lat.
Utile	lat.
Utilitarismus	neulat.
Utilität	lat.
Ut infra	lat.
Utriusque juris doctor	lat.
Ut supra	lat.
Uvula	lat.
Va banque	frz.
Vaccina	lat.
Vache	frz.
Vademekum	lat.
Vadium	neulat.
Vag	lat.
Vagabondage	frz.
Vagieren	lat.
Vagina	lat.
Vagus	lat.
Vakánt	lat.
Vakuolen	neulat.
Vakuum	lat.
Vakzination	lat.
Vale	lat.
Valet	lat.
Valet	frz.
Valeur	frz.
Vâli	türk.
Valid	lat.
Vâlideh	arab.
Valieren	lat.
Valuta	ital.
Valvation	lat.
Valvula	lat.
Vanitas vanitatum!	lat.
Vanity fair	engl.
Vapeurs	frz.
Vaporisation	neulat.
Vaporoso	ital.
Varia	lat.
Variabel	lat.
Variata	lat.
Variatio delectat	lat.
Variation	lat.
Varietät	lat.
Variété	frz.
Variolae	lat.
Variolation	neulat.
Varioloiden	lat.
Varix	lat.
Varizellen	lat.
Varsovienne	frz.
Vasáll	mittellat.
Vaskular	lat.
Vast	lat.
Vaticinium	lat.
Vaurien	frz.
Vauxhall	engl.
Vae victis	lat.
Vedette	frz.
Vedute	ital.
Vega	span.
Vegetation	lat.
Vegetativ	lat.
Vehemént	lat.
Vehikel	lat.
Velamént	lat.
Velare	lat.
Velarium	lat.
Velin	frz.
Velleïtät	neulat.
Vellón	span.
Veloce	ital.
Velours	frz.
Velozität	lat.
Velvet	engl.
Vena	lat.
Venal	lat.
Venäsektion	lat.
Venation	lat.
Vendétta	ital.
Venerabel	lat.
Venia	lat.
Veni creator Spiritus	lat.
Veni sancte Spiritus	lat.
Veni, vidi, vici	lat.
Venös	lat.
Venta	span.
Ventilation	lat.
Ventral	lat.
Ventre à terre	frz.
Ventriloquíst	lat.
Veranda	span.
Verazität	lat.
Verba	lat.
Verbal	lat.
Verbindung	chem.
Verbos	lat.
Verbum	lat.
Verde antico	ital.
Vergette	frz.
Verifizieren	lat.
Veritabel	frz.
Vermikulär	lat.
Vermillon	frz.
Vermizellen	ital.
Vernal	lat.
Verroterie	frz.
Vers	lat.
Versatil	lat.
Vers blancs	frz.
Versieren	lat.
Versifizieren	lat.
Versi liberi	ital.
Version	lat.
Versi sciolti	ital.
Versus memoriales	lat.
Verte	lat.
Vertebral	lat.
Vertigo	lat.
Vertikal	lat.
Vertugadins	frz.
Verve	frz.
Verwandlung	naturwiss.
Vespa	lat.
Vesper	lat.
Vestibül	frz.
Vestigia terrent	lat.
Veteranen	lat.
Veterinär	lat.
Veto	lat.
Vetturin	ital.
Vexation	lat.
Vexillum	lat.
Via	lat.
Viadukt	lat.
Viatikum	lat.
Vibration	lat.
Vi cessionis	lat.
Vice versa	lat.
Vicogne	frz.
Vicomte	frz.
Victrix causa diïs placuit, sed victa Catoni	lat.
Vide	lat.
Videant consules, ne quid respublica detriménti capiat	lat.
Vidi	lat.
Vielbrüderig	botan.
Vieux Saxe	frz.
Vigilánt	lat.
Vigilarius	lat.
Vigilien	lat.
Vigilieren	lat.
Vignetten	frz.
Vigor	lat.
Viktoria	lat.
Viktualien	lat.
Villanellen	ital.
Villeggiatur	ital.
Vinaigre	frz.
Vindikation	lat.
Vingt-et-un	frz.
Vinkulieren	lat.
Vino	ital.
Vinolént	lat.
Violation	lat.
Violént	lat.
Violétt	frz.
Violetta	ital.
Violino di pochetto	ital.
Violon	frz.
Violoncello	ital.
Virago	lat.
Virement	frz.
Virginität	lat.
Viribus unitis	lat.
Viridarium	lat.
Viril	lat.
Virtuéll	frz.
Virtuos	ital.
Virulént	lat.
Visa	lat.
Vis-a-vis	frz.
Vis comica	lat.
Visconte	ital.
Viscount	engl.
Visibel	lat.
Visier	lat.
Visieren	lat.
Vis inertiae	lat.
Vision	lat.
Visitation	lat.
Vis major	lat.
Vista	ital.
Visum	lat.
Viszeral	lat.
Vita brevis, ars longa	lat.
Vital	lat.
Vitalismus	neulat.
Vitalität	lat.
Vitalitium	mittellat.
Vitiligo	lat.
Vitragen	frz.
Vitreszieren	lat.
Vitrine	frz.
Vitrum Antimonii	lat.
Vivace	ital.
Vivarium	lat.
Vivat	lat.
Vivazität	lat.
Viviparen	lat.
Vivisektion	lat.
Vivos voco, mortuos plango, fulgura frango	lat.
Vizconde	span.
Vizinal	lat.
Vleet	holländ.
Vogue la galère	frz.
Voile	frz.
Vokabel	lat.
Vokale	lat.
Vokalisation	neulat.
Vokalise	frz.
Vokation	lat.
Vokativ	lat.
Volabel	lat.
Volant	frz.
Vol-au-vent	frz.
Volenti non fit injuria	lat.
Voliere	frz.
Volte	frz.
Voltigieren	frz.
Volubel	lat.
Volumen	lat.
Voluminös	lat.
Volute	lat.
Vomieren	lat.
Vorazität	lat.
Vorhof	anatom.
Vorübergang	astron.
Votum	lat.
Vovieren	lat.
Vox	lat.
Voyageur	frz.
Vulgär	lat.
Vulgata	lat.
Vulgivaga	lat.
Vulgo	lat.
Vulnerabel	lat.
Vulva	lat.
Vyehrad	tschech.
Wâdi	arab.
Waggon	frz.
Warp	engl.
Warrant	engl.
Warranted	engl.
Wash	engl.
Watercloset	engl.
Waterproof	engl.
Wealdenformation	engl.
Weft	engl.
Wekil	arab.
Welsh rabbit	engl.
Wesîr	arab.
Whipper-in	engl.
Whist	engl.
Whitebait	engl.
Whiteboys	engl.
Wjetsche	russ.
Wojßko	russ.
Wólost	russ.
Wood-oil	engl.
Wuchuchol	russ.
Wychocholj	russ.
Xanthopsie	grch.
Xenien	grch.
Xenios	grch.
Xenodochion	grch.
Xenokratie	grch.
Xylem	grch.
Xylographie	grch.
Xylolith	grch.
Xylometer	grch.
Xylophon	grch.
Yanigiri	japan.
Yankee	engl.
Yawl	engl.
Yellow metal	engl.
Yellow pine	engl.
Yellow root	engl.
Yellowwood	engl.
Zabel	mhd.
Zaddikim	hebr.
Zádruga	serb.
Zälatur	lat.
Zamponi	ital.
Zante	ital.
Zäsur	lat.
Zebaoth	hebr.
Zedént	lat.
Zedieren	lat.
Zedrat	ital.
Zelebránt	lat.
Zelebrieren	lat.
Zelerität	lat.
Zeloten	grch.
Zensieren	lat.
Zensit	lat.
Zensoren	lat.
Zensur	lat.
Zensus	lat.
Zentauren	mytholog.
Zentenarium	lat.
Zentesimal	lat.
Zentral	lat.
Zentralisation	lat.
Zentrieren	lat.
Zentrifugal	lat.
Zentripetal	lat.
Zentrum	lat.
Zephanja	hebr.
Zephyros	grch.
Zerebral	lat.
Zeremonial	lat.
Zernieren	frz.
Zertieren	lat.
Zertifikat	lat.
Zession	lat.
Zeugma	grch.
Zezidien	bot.
Zibarien	lat.
Ziborium	lat.
Zijl	holländ.
Ziliar	lat.
Zilien	lat.
Zinerarien	lat.
Zingulum	lat.
Zirkular	lat.
Zirkulation	lat.
Zirkulieren	lat.
Zirkumfléx	lat.
Zirkumskript	lat.
Zirkumvallationslinien	lat.
Zirkumzéntrisch	lat.
Zirkumzision	lat.
Zirkus	lat.
Ziselieren	frz.
Zissoide	grch.
Zistérne	lat.
Zitadelle	frz.
Zitat	lat.
Zitation	lat.
Zitieren	lat.
Zivil	lat.
Zivilisation	lat.
Zivilität	lat.
Zodiakus	grch.
Zoëtrop	grch.
Zölibat	lat.
Zone	grch.
Zoochemie	grch.
Zoogenie	grch.
Zoogeographie	grch.
Zooglöa	grch.
Zoogonie	grch.
Zooïatrik	grch.
Zoolatrie	grch.
Zoolithen	grch.
Zoolog	grch.
Zoologie	grch.
Zoomorphen	grch.
Zoonomie	grch.
Zoonose	grch.
Zoopaläontologie	grch.
Zooparasiten	grch.
Zoopathologie	grch.
Zoophag	grch.
Zoophylogenie	grch.
Zoophysik	grch.
Zoophysiologie	grch.
Zoospermien	grch.
Zoosporen	grch.
Zootherapie	grch.
Zootomie	grch.
Zorilla	span.
Zoster	grch.
Zuden	tschech.
Zygomórph	grch.
Zyklitis	grch.
Zykloide	grch.
Zyklometrie	grch.
Zyklopie	grch.
Zyklorama	grch.
Zyklus	lat.
Zylinder	grch.
Zymase	grch.
Zymologie	grch.
Zynegetik	grch.
Zyniker	grch.
Zyste	grch.
Zystis	grch.