Sumpfschnepfe	Bekassine
Berberis	Berberitze
Berberis	Sauerdorn
Synod	Heiliger
Taikun	Shogun
Talbrücke	Viadukt
Tamarindus	Tamarinde
Tamarix	Tamariske
Tamulen	Tamil
Tauschwirtschaft	Verkehrswirtschaft
Tecoma	Trompetenbaum
Tempelherren	Templer
Templer	Templerorden
Bergmann	Bergarbeiter
Bergmann	Bergknappe
Terminrechnung	Zeitrechnung
Teucrium	Gamander
Teufelsaustreibung	Exorzismus
Bergsturz	Bergrutsch
Thesis	These
Thorium	Thor
Thuja	Lebensbaum
Thymus	Thymian
Tierepos	Tierfabel
Tobsucht	Raserei
Tortur	Folter
Transformator	Umformer
Traubenzucker	Glukose
Traubenzucker	Dextrose
Triasformation	Trias
Trigonélla	Bockshornklee
Berufung	Appellation
Tsetse	Tsetsefliege
Tuareg	Targi
Beschäler	Deckhengst
Tuffkalk	Tuffstein
Tulipa	Tulpe
Tümmlertauben	Tümmler
Beschlag	Beschlagnahme
Turbodynamo	Turbogenerator
Türkische Bagdette	Türkentaube
Türkische Bohne	Feuerbohne
Typha	Rohrkolben
Unterbindung	Ligatur
Unterschlagung	Veruntreuung
Urgeschichte	Prähistorie
Urtica	Nessel
Urtica	Brennessel
Valeriana	Baldrian
Valerianélla	Rapunzel
Betonica	Betonie
Betsäule	Bildstock
Ventilation	Lüftung
Verband	Bandage
Verbascum	Königskerze
Verbascum	Wollkraut
Veredlung	Impfung
Verknöcherung	Ossifikation
Veronica	Ehrenpreis
Beutelmarder	Raubbeutler
Versicherungsgebühr	Versicherungsprämie
Versicherungsschein	Police
Verwaltung	Administration
Verwesen	Fehlgeburt
Vesuvian	Wiluit
Veterinärkunde	Veterinärmedizin
Vicia	Wicke
Viertelstab	Wulst
Viscum	Mistel
Vitriolbleierz	Anglesit
Volkswirtschaftslehre	Nationalökonomie
Vollschiff	Dreimaster
Bezifferung	Tabulatur
Vorhalt	Retardation
Vries	Fries
Wachsstrauch	Gagelstrauch
Währung	Valuta
Waldstein	Großer
Walker	Gerber
Walker	Müller
Wamme	Triel
Wanst	Pansen
Warane	Warner
Wasseramsel	Wasserschmätzer
Wasserwage	Libelle
Watercloset	Wasserklosett
Weichflügler	Weichkäfer
Weichhäuter	Weichkäfer
Weißbleierz	Cerussit
Bidens	Zweizahn
Weißkohl	Weißkraut
Wellhorn	Wellhornschnecke
Weltkugel	Himmelsglobus
Werkverdingung	Werkvertrag
Wetterprognose	Wettervorhersage
Wettersäule	Windhose
Bienenschwärmer	Hornissenschwärmer
Affenbrotbaum	Baobab
Windbüchse	Luftgewehr
Windbüchse	Luftpistole
Windrose	Kompaßrose
Wirsing	Mailänder
Wochenbett	Kindbett
Würfel	Kubus
Xeranthemum	Strohblume
Yak	Jak
Bildhauerkunst	Skulptur
Zahnarme	Zahnlose
Zahnarzneikunst	Zahnheilkunde
Zäumung	Zaumzeug
Zehn Gebote	Dekalog
Zenturien	Magdeburger
Bimsstein	Bums
Zeugung	Fortpflanzung
Zider	Obstwein
Binder	Strecker
Zirkonium	Zirkon
Zistenröschen	Zistrose
Zitation	Vorladung
Zostera	Seegras
Zuckerriementag	Zuckertang
Zugbrücke	Fallbrücke
Zwangsvollstreckung	Exekution
Zwergente	Kragenente
Zwetschengeist	Zwetschenwasser
Zwölffeder	Geißblattgeistchen
Birkenspinner	Wollafter
Birkhuhn	Moorhuhn
Birne	Birnbaum
Bisamkraut	Moschuskraut
Bisamochse	Moschusochse
Bisamochse	Schafochse
Bisamschwein	Nabelschwein
Bischofsstab	Krummstab
Bittermandelöl	Benzaldehyd
Aftererbe	Nacherbe
Blanik	Großer
Blättermagen	Psalter
Blättermagen	Büchlein
Blattkohl	Grünkohl
Blattkohl	Braunkohl
Blattroller	Stecher
Blaufisch	Springer
Blaufuchs	Polarfuchs
Agalmatolith	Pagodit
Agalmatolith	Bildstein
Blindendruck	Hochdruck
Blitzgefahr	Blitzschlag
Agaricus	Blätterpilz
Blümlisalp	Frau
Bogenstrich	Bogenführung
Boll	Bole
Agito	Giro
Böttger	Böttcher
Agosta	Augusta
Brachvogel	Brachschnepfe
Brand	Gangrän
Agrimonia	Odermennig
Agropyrum repens	Quecke
Agrostis	Straußgras
Abdecker	Schinder
Ailanthus	Götterbaum
Ajuga	Günsel
Calendula	Ringelblume
Chronoskop	Chronograph
Cirrokumulus	Schäfchen
Cladonia	Astflechte
Coati	Nasenbär
Abendpfauenauge	Nachtpfauenauge
Cymbalum	Zimbel
Darrsucht	Darre
Dickfuß	Triel
Algerien	Algier
Döbel	Dickkopf
Alisma	Froschlöffel
Dolores	Stadt
Alkoholismus	Alkoholvergiftung
Dronte	Dodo
Alligator	Kaiman
Eidechsen	Saurier
Eierschwamm	Pfifferling
Aloë	Aloe
Alopecurus	Fuchsschwanz
Elastizität	Federkraft
Elentier	Elen
Elentier	Elch
Altersschwäche	Marasmus
Althaea	Eibisch
Eriophorum	Wollgras
Erodium	Reiherschnabel
Ertragssteuer	Realsteuer
Ertragssteuer	Objektsteuer
Estafette	Stafette
Euphorbia	Wolfsmilch
Euphrasia	Augentrost
Aluta	Alt
Evolutionstheorie	Entwicklungstheorie
Evonymus	Spindelbaum
Expropriation	Enteignung
Fähnlein	Fahne
Fahrende Habe	Fahrnis
Amarántus	Amarant
Amarántus	Fuchsschwanz
Fällung	Präzipitation
Farbenlehre	Chromatik
Färse	Kalbe
Faule	Faulsein
Faustbüchse	Fäustling
Federmotten	Geistchen
Ableitung	Derivation
Feldmeßkunst	Geodäsie
Feldmeßkunst	Landesvermessung
Fen	Fan
Fennek	Wüstenfuchs
Fernrohr	Teleskop
Festtage	Feste
Festuca	Schwingel
Fettgeschwulst	Lipom
Feuchtblatt	Feige
Feuerbusch	Feuerdorn
Feuerkugeln	Bolide
Feuerlinge	Feuerfalter
Feuerstein	Flint
Feuerwanze	Soldat
Feuerwanze	Dragoner
Feuerwerkerei	Pyrotechnik
Fibroid	Fibrom
Fibula	Fibel
Fichteneule	Forleule
Fichteneule	Kieferneule
Fieberkurve	Temperaturkurve
Ameisenlöwe	Ameisenjungfer
Amelanchier	Felsenbirne
Fingerentzündung	Umlauf
Fischbai	Große
Fischfluß	Großer
Fischotter	Otter
Flagellánten	Geißler
Flamberg	Flammenschwert
Fleischer	Metzger
Fleischer	Schlächter
Flügelaltar	Wandelaltar
Amiranten	Admiralitätsinseln
Fohlen	Füllen
Ammenzeugung	Generationswechsel
Fördermaschine	Förderung
Freifräulein	Freiin
Freiheitsmütze	Jakobinermütze
Abortus	Fehlgeburt
Frett	Frettchen
Fröschleingeschwulst	Frosch
Fruchtfolge	Rotation
Fruchtvögel	Schwätzer
Fruchtzucker	Fruktose
Fuchsia	Fuchsie
Fuchsin	Rubin
Fuchsin	Magenta
Fucus	Blasentang
Fucus	Seetang
Fühlhörner	Fühler
Fumaria	Erdrauch
Fundschein	Obduktionsbericht
Furchung	Klüftung
Fuß	Schuh
Fußmörser	Böller
Gabelung	Dichotomie
Gagel	Gagelstrauch
Galánthus	Schneeglöckchen
Galeobdolon	Goldnessel
Galeópsis	Hohlzahn
Aalraupe	Quappe
Aalraupe	Aalquappe
Aalraupe	Rutte
Galium	Labkraut
Galvanische Batterie	Säule
Gänsekraut	Gänsekresse
Garbe	Schafgarbe
Gärung	Fermentation
Gasäther	Gasolin
Gaskraftmaschine	Gasmotor
Gassenlaufen	Spießrutenlaufen
Gastwirt	Restaurateur
Gebärmutter	Mutter
Geckonen	Haftzeher
Anagállis	Gauchheil
Gefolgschaft	Gefolge
Gelbbleierz	Wulfenit
Gemse	Gams
Generalinquisitor	Großinquisitor
Genista	Ginster
Gentiana	Enzian
Gerade Aufsteigung	Rektaszension
Geradflügler	Schrecken
Gerichtsbarkeit	Jurisdiktion
Gerichtskosten	Gerichtsgebühren
Geschäftsgeheimnis	Betriebsgeheimnis
Geschichte	Historie
Geschoß	Projektil
Geschützbronze	Stückgut
Gesellschaftswissenschaft	Soziologie
Gesetzsammlung	Gesetzblatt
Gesicht	Angesicht
Gesicht	Antlitz
Anchusa	Ochsenzunge
Geweih	Gehörn
Abrudbánya	Altenburg
Gìbbon	Langarmaffe
Andes	Los
Gleichflügler	Zirpen
Andromeda	Rosmarinheide
Glockenvogel	Glöckner
Glockner	Großglockner
Andropogon	Bartgras
Glyceria	Süßgras
Glyoyrrhiza	Süßholz
Gnaphalium	Ruhrkraut
Anemone	Windröschen
Goldsolidus	Solidus
Anethum	Dill
Anethum	Gurkenkraut
Angelica	Engelwurz
Goethe-Nationalmuseum	Goethehaus
Göttergeschick	Ragnarök
Angiopteris	Palmfarn
Abschlagszahlung	Anzahlung
Abschlagszahlung	Teilzahlung
Greifzirkel	Taster
Großjährigkeit	Volljährigkeit
Grundbau	Gründung
Grundbau	Fundamentierung
Grundbau	Fundierung
Gründüngung	Gründung
G-Schlüssel	Violinschlüssel
Gummipflaster	Zugpflaster
Gurjunbalsam	Holzöl
Gürtelflechte	Gürtelrose
Gymnogramme	Nacktfarn
Gypsophila	Gipskraut
Haar	Haarstrang
Hackebrett	Zymbal
Haferwurzel	Haferwurz
Hagedorn	Weißdorn
Hakenfink	Hakengimpel
Halbgeschoß	Zwischengeschoß
Hammerfisch	Hammerhai
Handelsfrau	Kauffrau
Handlungsreisender	Geschäftsreisender
Hanswurst	Harlekin
Harnisch	Küraß
Haselnußstrauch	Hasel
Haubentaucher	Steißfuß
Hauskommunion	Hausgemeinschaft
Hechtdorsch	Seehecht
Hedonik	Hedonismus
Antennaria	Katzenpfötchen
Anthemis	Hundskamille
Anthoxanthum	Ruchgras
Anthrazit	Glanzkohle
Anthriscus	Kerbel
Hessus	Koch
Heulwolf	Steppenwolf
Heulwolf	Präriewolf
Heulwolf	Coyote
Himbeere	Himbeerstrauch
Hirschkäfer	Baumschröter
Hof	Halo
Hornbaum	Weißbuche
Hornbaum	Hainbuche
Hottonia	Wasserfeder
Anziehung	Attraktion
Apfel	Apfelbaum
Apium	Sellerie
Intramerkuriéller Planet	Vulkan
J	Jot
Appretur	Zurichtung
Pfalzgraf bei Rhein Johann Kasimir	Pfalzgraf
Johannes der Presbyter	Erzbischof
Johanniswürmchen	Leuchtkäfer
Junikäfer	Gartenlaubkäfer
Aquilegia	Akelei
Kaiserling	Eierschwamm
Arabis	Gänsekresse
Kampfläufer	Kampfhahn
Arapiles	Los
Kapuzinerpilz	Birkenpilz
Kapybara	Wasserschwein
Acacia	Akazie
Kassaï	Kwa
Katzenbär	Panda
Kauf	Kaufvertrag
Arbutus	Erdbeerbaum
Archangelica	Engelwurz
Acanthus	Bärenklau
Archimedische Schraube	Wasserschnecke
Arctostaphylos	Bärentraube
Kirchenbann	Exkommunikation
Kirchendiebstahl	Kirchenraub
Klammeraffe	Stummelaffe
Klettermeisen	Baumläufer
Klettermeisen	Baumrutscher
Aare	Aar
Kohlrübe	Steckrübe
Kohlrübe	Dorsch
Koloradokäfer	Kartoffelkäfer
Kolumbien	Columbia
Aristolochia	Osterluzei
Konsolidation	Konsolidierung
Kormoran	Scharbe
Kote	Kate
Kreuzotter	Otter
Kuguar	Puma
Kukurbeta	Großer
Küstenschiffahrt	Küstenfahrt
Lactarius	Milchling
Laminaria	Riementang
Lamium	Taubnessel
Landesdirektor	Landeshauptmann
Landesherrlichkeit	Landeshoheit
Ländler	Dreher
Landrichter	Landgerichtsrat
Landstreicher	Vagabund
Lappa	Klette
Lärmstange	Fanal
Lathyrus	Platterbse
Artocarpus	Brotfruchtbaum
Achene	Achäne
Achene	Schließfrucht
Arum	Aronstab
Lavandula	Lavendel
Lederfabrikation	Gerberei
Ledum	Porst
Legat	Vermächtnis
Asarum	Haselwurz
Leichenverbrennung	Feuerbestattung
Leichenverbrennung	Kremation
Leihhaus	Pfandhaus
Leihhaus	Lombard
Leinölsäure	Linolsäure
Leinpfad	Treidelweg
Leinwand	Leinen
Äsche	Mailing
Aschenbrödel	Aschenputtel
Achillea	Schafgarbe
Lepidium	Kresse
Ligustrum	Liguster
Asklepios	Äskulap
Lilium	Lilie
Liquidambar	Amberbaum
Listenskrutinium	Listenwahl
Llanos	Los
Löffelhund	Kaffer
Asplenium	Streifenfarn
Lolium	Lolch
Lorette	Kokotte
Lösung	Auflösung
Lotsenfisch	Pilot
Lotus	Hornklee
Luftschiffahrt	Aeronautik
Lunaria	Silberblatt
Ast	Schlag
Luzon	Manila
Luzula	Hainsimse
Lychnis	Lichtnelke
Lycopodium	Bärlapp
Lythrum	Weiderich
Madenwurm	Springschwanz
Magnesit	Bitterspat
Astrantia	Sterndolde
Astrantia	Meisterwurz
Mairübe	Speiserübe
Majanthemum	Schattenblume
Major Domus	Hausmeier
Makari	Kotoko
Therese Malten	Müller
Malva	Malve
Atavismus	Rückschlag
Mandelkrähe	Blauracke
Mandingo	Malinke
Mandingo	Bambara
Mandingo	Susu
Manga	Mangopflaume
Manganspat	Himbeerspat
Manganspat	Rhodochrosit
Mara	Pampashase
Marabu	Adjutant
Maranta	Pfeilwurz
Margarit	Perlglimmer
Margarit	Kalkglimmer
Marishal	Lord
Aethiops	Mohr
Mars	Marmor
Martini	Martinsfest
Märzbewegung	Märzrevolution
Maschinengeschütz	Maschinenkanone
Atolle	Laguneninseln
Mauerbohrer	Tarant
Mauerschwalben	Segler
Maurizio	Porto
Atriplex	Melde
Mechanische Wärmetheorie	Thermodynamik
Medicago	Schneckenklee
Medizinalwesen	Sanitätswesen
Mehlfabrikation	Müllerei
Melaphyr	Trapp
Melica	Perlgras
Melilotus	Steinklee
Melissa	Melisse
Mentha	Minze
Mercurialis	Bingelkraut
Merkantilsystem	Merkantilismus
Meßrute	Meßstab
Met	Honigwein
Ackerbau	Agrikultur
Meum	Bärwurz
Milchwirtschaft	Meierei
Milium	Flattergras
Mimose	Sinnpflanze
Mirabilis	Wunderblume
Aufsichtsrat	Verwaltungsrat
Mißbildung	Mißgeburt
Mitreederei	Reederei
Mnemonik	Mnemotechnik
Mnium	Sternmoos
Augenheilkunde	Ophthalmologie
Mohrrübe	Karotte
Augenspiegel	Ophthalmoskop
Mondzirkel	Mondzyklus
Monotropa	Fichtenspargel
Moor	Moos
Moor	Filz
Morchélla	Morchel
Aurifaber	Goldschmied
Acorus	Kalmus
Münzfälschung	Falschmünzerei
Muscari	Traubenhyazinthe
Muscogee	Muskogee
Mutter	Schraubenmutter
Nachtwandeln	Somnambulismus
Nachtwandeln	Schlafwandeln
Nagetiere	Nager
Name	Personenname
Narcissus	Narzisse
Nargileh	Wasserpfeife
Narthecium	Ährenlilie
Narthecium	Beinbrech
Nationalflagge	Handelsflagge
Nebelkappe	Tarnkappe
Nepeta	Katzenminze
Nephrit	Beilstein
Nesselausschlag	Nesselsucht
Nickfänger	Nicker
Niederdeutsch	Plattdeutsch
Aventurin	Avanturin
Aventurin	Aventurinquarz
Nilpferd	Flußpferd
Aventurinfeldspat	Sonnenstein
Nix	Neck
Nix	Nöck
Normalschule	Musterschule
Normannische Inseln	Kanalinseln
Axis	Axishirsch
Ohrensteißfuß	Ohrentaucher
Ol	Wall
Oleinsäure	Ölsäure
Olivin	Peridot
Olm	Grottenolm
Ölung	Letzte
Omissivdelikt	Unterlassungsdelikt
Oenánthe	Rebendolde
Ononis	Hauhechel
Opium	Mohnsaft
Opuntia	Feigenkaktus
Orchis	Knabenkraut
Origanum	Dost
Orobanche	Sommerwurz
Orobanche	Würger
Ozeanien	Polynesien
Ozeanisches Klima	Seeklima
Baden	Baden-Baden
Pancratium	Trichterlilie
Pastinake	Pastinak
Pauke	Kesselpauke
Pedicularis	Läusekraut
Peilen	Peilung
Pelikan	Kropfgans
Bakau	Baku
Perlit	Perlstein
Peucedanum	Haarstrang
Pfahlgraben	Limes
Pferderechen	Heurechen
Pfirsich	Pfirsichbaum
Pflaume	Pflaumenbaum
Balggeschwulst	Zyste
Phyteuma	Rapunzel
Picker	Webervogel
Pilger	Pilgrim
Pinguicula	Fettkraut
Plattieren	dublieren
Platzangst	Agoraphobie
Plenarsitzung	Plenum
Plötze	Rotauge
Poa	Rispengras
Polierschiefer	Klebschiefer
Polk	Pulk
Bambusa	Bambus
Polygonum	Knöterich
Polyporus	Löcherpilz
Pontifikalmesse	Pontifikalamt
Posilipotuff	Puzzolan
Posten	Roller
Postporto	Porto
Potentilla	Fingerkraut
Praia	Porto
Pranger	Schandpfahl
Pressionsführung	Forcierung
Pulicaria	Flohkraut
Pulmonaria	Lungenkraut
Pulsatilla	Küchenschelle
Puppe	Chrysalis
Bär	Bärenspinner
Pustel	Blatter
Quartermeister	Quartiermeister
Quittenbaum	Quitte
Ranunculus	Hahnenfuß
Rapsfloh	Rapserdfloh
Raseneisenstein	Raseneisenerz
Raseneisenstein	Limonit
Raserei	Tobsucht
Rattenfänger	Rattler
Rauschbrand	Geräusch
Rechtsanwalt	Sachwalter
Rechtsanwalt	Advokat
Rechtschreibung	Orthographie
Rechtsgelehrsamkeit	Jurisprudenz
Rechtswissenschaft	Jurisprudenz
Reïteration	Iteration
Reïteration	Repetition
Reliefdruck	Prägedruck
Renke	Felchen
Rennarbeit	Rennen
Rennstieg	Rennsteig
Repetént	Repetitor
Reseda	Resede
Rhätoromanisch	Romanisch
Rhätoromanisch	Ladinisch
Rhyolith	Liparit
Riechbein	Siebbein
Bartsinne	Bartflechte
Adiántum	Frauenhaar
Robinia	Akazie
Rock	Heiliger
Roßhaar	Pferdehaar
Rotbleierz	Krokoit
Roteisenerz	Roteisenstein
Rotkohl	Rotkraut
Rotzkrankheit	Wurm
Basilienkraut	Basilikum
Rundiste	Einfassung
Ruta	Raute
Bassétthorn	Krummhorn
Saalach	Saal
Saccharum	Zuckerrohr
Adjektiv	Eigenschaftswort
Sagittaria	Pfeilkraut
Saibling	Ritter
Salpeter	Kalisalpeter
Salzkote	Halle
Sambucus	Holunder
Sambucus	Holder
Sammelglas	Sammellinse
Sanitätskorps	Sanitätspersonal
Santorin	Thira
Saponaria	Seifenkraut
Saria	Soso
Saxifraga	Steinbrech
Schächerkreuz	Gabelkreuz
Bauführer	Bauleiter
Schaumzirpe	Schaumzikade
Scheelbleierz	Stolzit
Scheelit	Tungstein
Schiffer	Schiffsführer
Schiffer	Kapitän
Schiffsdirektor	Schiffseigner
Schiffsjournal	Logbuch
Schlachthaus	Schlachthof
Schlagfluß	Schlag
Schleppnetz	Zugnetz
Schlieg	Schlich
Schlüpfer	Zaunschlüpfer
Schmälen	Schrecken
Schmaljungfer	Schneider
Schmarotzertum	Parasitismus
Schmelzbutter	Butterschmalz
Schmetterlinge	Falter
Schnellkraft	Federkraft
Schornstein	Esse
Schoßbein	Schambein
Schotter	Steinschlag
Schraubenbohrer	Gewindebohrer
Schraubenpropeller	Schiffsschraube
Schreckhorn	Kleines
Schuldschein	Schuldverschreibung
Schwammspinner	Großkopf
Schweißhund	Bluthund
Schwere	Schwerkraft
Schwerspat	Baryt
Schwingung	Vibration
Schwingung	Oszillation
Schwungrad	Schwungscheibe
Schwurgericht	Geschworenengericht
Schwurgericht	Jury
Scilla	Blaustern
Scrophularia	Braunwurz
Sedum	Fetthenne
Sedum	Mauerpfeffer
Seebarbe	Meerbarbe
Seeföhre	Seeforelle
Seehase	Lump
Seeotter	Meerotter
Seepolyp	Krake
Seeraub	Piraterie
Seezeichen	Schiffahrtszeichen
Seguro	Porto
Seidenhase	Angorakaninchen
Selbstherrscher	Autokrat
Selbstschuldner	Selbstzahler
Adlervitriol	Bayreuther
Adlervitriol	Salzburger
Senecio	Kreuzkraut
Sequestration	Zwangsverwaltung
Sextus	Liber
Beerberg	Großer
Sgraffito	Graffito
Sheddach	Sägedach
Sichelreiher	Sichler
Befestigungskunst	Fortifikation
Siebengestirn	Plejaden
Befreiungskrieg	Deutscher
Silene	Leimkraut
Siphonia	Gummibaum
Siphonia	Kautschukbaum
Sirach	Jesus
Sium	Merk
Sklavenfluß	Großer
Sklavensee	Großer
Solanum	Nachtschatten
Soldanella	Alpenglöckchen
Solidago	Goldrute
Sonchus	Gänsedistel
Sonnabend	Samstag
Sonnenzirkel	Sonnenzyklus
Sorbus	Eberesche
Spadizifloren	Kolbenblütler
Spannungsmesser	Voltmeter
Belehnung	Investitur
Speckstein	Steatit
Spergula	Spergel
Sperling	Spatz
Spiritusfabrikation	Brennerei
Spreu	Kaff
Springbrunnen	Fontäne
Sprotte	Breitling
Stachelbeere	Stachelbeerstrauch
Stachelpilz	Stoppelpilz
Stachys	Ziest
Statue	Standbild
Statue	Bildsäule
Stechrochen	Stachelrochen
Steinfrucht	Steinbeere
Moritz Steinla	Müller
Steinmasse	Kunststein
Stellaria	Sternmiere
Steuermannskunst	Navigation
Steuermannskunst	Nautik
Adonis	Adonisröschen
Stiller Ozean	Südsee
Strafbefehl	Strafmandat
Strafvollzug	Strafvollstreckung
Strahlstein	Aktinolith
Bengel	Flegel
Strohfiedel	Xylophon
Stromwender	Umschalter
Abladen	befrachten
Ablauf	Böschung
Abschied	Dienstentlassung
Absis	Apsis
Abt	Abbé
Abzehrung	Auszehrung
Accrescendo	Crescendo
Achiver	Achäer
Advis	Avis
Afterdolde	Trugdolde
Agtstein	Bernstein
Air	Arie
Akkordion	Ziehharmonika
Akkumulatoren	Sammler
Akzidentalen	Versetzungszeichen
Alexandreia	Alexandria
Altviole	Bratsche
Amaltheia	Füllhorn
Amelkorn	Emmer
Amerika-Inseln	Fanninginseln
Ammer	Emmer
Amoriter	Kanaaniter
Ampferklee	Sauerklee
Amrom	Amrum
Analemma	Astrolabium
Anglisieren	englisieren
Annéx	Annexion
Anonym	Aktiengesellschaft
Anteilschein	Aktie
Antiklinale	Sattel
Apfelwein	Zider
Appartement	Abort
Äquivok	Urzeugung
Ärarium	Fiskus
Arbeitsübertragung	Kraftübertragung
Armatur	Anker
Arsacideninseln	Salomoninseln
Assortiment	Sortiment
Astronomischer Ring	Astrolabium
Aszendénten	Rektaszension
Aul	Dorf
Auslobung	Abfindung
Auspex	Augur
Australozean	Südsee
Autocab	Automobil
Autoskopie	Autopsie
Avanzo	Avance
Aviation	Flugtechnik
Babel	Babylon
Bader	Barbier
Bahamaholz	Rotholz
Baladea	Neukaledonien
Balance	Unruhe
Balgkapsel	Balgfrucht
Ballier	Polier
Baltisches Meer	Ostsee
Bangla	Bungalow
Bankert	Bastard
Bärenwurzel	Bärwurz
Bärme	Hefe
Baron	Freiherr
Bartholomäussee	Königssee
Baryt	Schwerspat
Basaltit	Melaphyr
Basaltit	Basalt
Baß	Kontrabaß
Basse-taille	Bariton
Bastardeisen	Nickel
Baster	Bastard
Bauernleier	Drehleier
Béfort	Belfort
Beinhaut	Knochenhaut
Belo...	Weiß
Benefiziánt	Pfründe
Bernstein	Gagat
Besing	Heidelbeere
Bettlerleier	Drehleier
Bevollmächtigter Minister	Gesandter
Bewetterung	Wetterführung
Bey	Beg
Bibliothekzeichen	Exlibris
Bickbeere	Heidelbeere
Billett	Banknote
Bin	Major
Binär	Dyadik
Biographie	Kinematograph
Biologie	Physiologie
Biosophie	Physiologie
Bjel...	Weiß
Bjelo...	Weiß
Blafard	Albino
Blässe	Bläßhuhn
Blaues Meer	Aralsee
Blendling	Bastard
Blicken	Einkorn
Blockschiff	Hulk
Blumensonntag	Palmsonntag
Blutpilz	Satanspilz
Blutzeugen	Märtyrer
Boabab	Baobab
Bogner	Bogenschütze
Böhmisch-Sächsisches Sandsteingebirge	Elbsandsteingebirge
Boxer	Bulldogge
Br.	Brief
Brahme	Senkblei
Brandassekuranz	Feuerversicherung
Bredouille	Verlegenheit
Brigadier	Brigadegeneral
Bronzealter	Bronzezeit
Bruchbeere	Heidelbeere
Bubonenpest	Beulenpest
Bums	Bimsstein
Bundesversammlung	Bundestag
Bussole	Kompaß
Büttner	Böttcher
Caerdiff	Cardiff
Candia	Kreta
Canot	Kanu
Cape Town	Kapstadt
Capite censi	Proletarier
Cebú	Zebu
Certosa	Kartause
Chacham	Rabbiner
Charge	Dienstgrad
Chef	Inhaber
Chilisalpeter	Chilesalpeter
Chinabaum	Chinarindenbaum
Choreus	Trochäus
Christdorn	Stechpalme
Christianit	Anorthit
Christrose	Nieswurz
Ciaccona	Chaconne
Circulaire	Zirkular
Clavecin	Cembalo
Clerc	Geistlicher
Cod-liver oil	Lebertran
Cod-oil	Lebertran
Coloninseln	Galapagosinseln
Comménda	Kommende
Constitutio	Verordnung
Contre	Kontertanz
Coquille	Hartguß
Cosa	Algebra
Counsel	Barrister
Currachee	Karatschi
Dacca	Dhaka
Dachhaube	Zwiebelhaube
Dachlauch	Hauswurz
Dächsel	Dachshund
Dachwurzel	Hauswurz
Dakka	Dhaka
Dakoromanisch	Rumänisch
Damara	Herero
Damoiseau	Fräulein
Dampfboot	Dampfschiff
Däumling	Daumen
Deduktion	Abzug
Defäkation	Scheidung
Defekation	Defäkation
Dekreditieren	diskreditieren
Denka	Dinka
Deposition	Depotgeschäft
Dettenried	Delle
Deul	Luppe
Deutsches Meer	Nordsee
Deviation	Derivation
Dextrose	Traubenzucker
Dialyse	Diäresis
Diaphragma	Blendung
Differentiieren	Differenzieren
Diffraktion	Beugung
Digestion	Verdauung
Digéstor	Dampfkochtopf
Digression	Elongation
Diplom	Urkunde
Dirigént	Direktor
Diskánt	Sopran
Dîwân	Staatsrat
Donnerbesen	Hexenbesen
Doornik	Tournai
Doppelwappen	Allianzwappen
Dor	Bongo
Dorsch	Kohlrübe
Dossierung	Böschung
Doublestoff	Eskimo
Doyen	Dechant
Drachenpalme	Drachenbaum
Drachenwurz	Schlangenwurz
Dragant	Tragant
Drechselbank	Drehbank
Dreifaltigkeitsblume	Stiefmütterchen
Dulzinea	Geliebte
Dünenhafer	Strandhafer
Durák	Narr
Dynamo-elektrische Maschine	Dynamomaschine
Ebenstrauß	Doldentraube
Edelwild	Rotwild
Ehekontrakt	Ehevertrag
Eichhorn	Eichhörnchen
Eingelegte Arbeit	Intarsia
Eisenperiode	Eisenzeit
Eisspat	Adular
Elefantenfluß	Olifant
Elektrische Kur	Elektrotherapie
Elektrischer Generator	Dynamomaschine
Elektrischer Motor	Elektromotor
Elektromagnetische Maschine	Dynamomaschine
Elektroplástik	Galvanoplastik
Eller	Erle
Elsbeere	Eberesche
Elzebeere	Eberesche
Empirestil	Klassizismus
Endechrist	Antichrist
Entbindungskunst	Geburtshilfe
Entrata	Introduktion
Epistyl	Architrav
Epópten	Schwärmer
Eppich	Sellerie
Eppich	Efeu
Erbbestand	Erbpacht
Erchtag	Dienstag
Erdbebenmesser	Seismometer
Erderschütterung	Erdbeben
Erdpistazie	Erdmandel
Erdwolf	Maulwurfsgrille
Erlitz	Adler
Erlöser	Heiland
Ermitage	Eremitage
Ertag	Dienstag
Erwerbssteuer	Gewerbesteuer
Esdragon	Estragon
Eskompte	Diskonto
Eteográmm	Chronogramm
Eubiotik	Diätetik
Eulogie	Eucharistie
Eunuch	Kastrat
Exedra	Apsis
Exekution	Hinrichtung
Exstirpation	Grubber
Faktor	Kommissionär
Fallbeil	Guillotine
Fallbrücke	Zugbrücke
Fallende Sucht	Epilepsie
Fallzünder	Aufschlagzünder
Falscheid	Meineid
Falu	Dorf
Fanfare	Tusch
Farbenzerstreuung	Dispersion
Farce	Burleske
Farren	Farn
Fâs	Fes
Fasel	Nachwuchs
Fassonieren	Kopiermaschine
Fechten	eichen
Feigbohne	Lupine
Feldmesser	Geometer
Feldregulierung	Feldbereinigung
Felgen	Grubber
Ferîk	Division
Ferîk	Divisionsgeneral
Fermentation	Gärung
Fernambukholz	Rotholz
Feudum	reaktionär
Feuerkasten	Feuerbüchse
Fiji-Inseln	Fidschi-Inseln
Firka	Division
Firmenregister	Handelsregister
Firnistuch	Wachstuch
Firth	Fjord
Fjärd	Fjord
Flämische Inseln	Azoren
Flaschner	Klempner
Flaus	Fries
Fleurist	Florist
Flittergras	Zittergras
Florentiner Arbeit	Mosaik
Florilegium	Anthologie
Flötz	Flöz
Flugsommer	Altweibersommer
Föderation	Konföderation
Föhrde	Fjord
Föhre	Kiefer
Förde	Fjord
Forle	Kiefer
Formylsäure	Ameisensäure
Franche	Franse
Frankatur	Frankierung
Freia	Freyja
Frosch	Daumen
Fulgurit	Blitzröhre
Fund	Fonds
Fundlohn	Finderlohn
Fürsprech	Rechtsanwalt
Fylfot	Hakenkreuz
Gabelton	Kammerton
Gabler	Gabelweihe
Gadhelisch	Gälisch
Gaelisch	Gälisch
Galvanolyse	Elektrolyse
Garotte	Garrotte
Gastrologie	Gastronomie
Geding	Vertrag
Gefäßgeschwulst	Angiom
Gegenklage	Widerklage
Geigenharz	Kolophonium
Gelehrtenschule	Gymnasium
Generalfeldwachtmeister	Generalmajor
Generation	Zeugung
Generator	Dynamomaschine
Geschoßbahn	Flugbahn
Gesichtswinkel	Sehwinkel
Gewerbegenossenschaft	Innung
Gewerk	Handwerk
Gique	Gigue
Giro	Indossament
Glasschwärmer	Glasflügler
Glättmaschine	Kalander
Glorie	Heiligenschein
Goldbarsch	Kaulbarsch
Goldschaum	Blattgold
Goldstoff	Brokat
Gotenburg	Göteborg
Gothenburg	Göteborg
Grad	Burg
Gradstock	Jakobsstab
Grège	Rohseide
Grezseide	Rohseide
Griechische Liebe	Päderastie
Grundbesitz	Grundeigentum
Grundgesetz	Verfassungsurkunde
Grundstock	Jakobsstab
Grusonmetall	Hartguß
Guerre	Pseudonym
Gummilack	Schellack
Gunny	Jute
Güterpfleger	Konkursverwalter
Gütertrennung	Verwaltungsgemeinschaft
Haarzange	Pinzette
Hafner	Töpfer
Hagel	Kartätsche
Hagion Oros	Athos
Halbbürtige Geschwister	Halbgeschwister
Halbkasten	Eurasier
Halbmeister	Abdecker
Hämmling	Kastrat
Handelsflotte	Handelsmarine
Handelsgremium	Handelskammer
Handschrift	Graphologie
Hantieren	Handel
Häresie	Ketzerei
Hauptbaß	Generalbaß
Hegumenos	Abt
Heidekorn	Buchweizen
Heiliges Bein	Kreuzbein
Heimbürge	Gemeindevorsteher
Heiratswappen	Allianzwappen
Heister	Elster
Hellas	Mittelgriechenland
Helmbarte	Hellebarde
Herbstfäden	Altweibersommer
Hermes	Schwärmer
Heroisch	Hexameter
Himeros	Eros
Hinterlegung	Deposition
Hirtenstab	Bischofsstab
Histiologie	Histologie
Hochton	Akzent
Hofmeister	Hauslehrer
Höfte	Buhne
Hohe Schule	Universität
Honigwein	Met
Horribilicribrifax	Maulheld
Hortus siccus	Herbarium
Humbug	Schwindel
Hurrikan	Orkan
Hydrostatische Wage	Aräometer
Hypérbel	Übertreibung
Ideador	Kaleidoskop
Imker	Bienenzüchter
Imperator	Kaiser
Indian grass	Jute
Indúlt	Moratorium
Indúlt	Messe
Industriéll	Fabrikant
Inn	Amtsgebäude
Innung	Zunft
Inskribieren	immatrikulieren
Inskription	Immatrikulation
Intermediär	Intermezzo
Internationales Recht	Völkerrecht
Interzession	Bürgschaft
Jagdhorn	Waldhorn
Jagen	Abteilung
Jargon	Kauderwelsch
Jean Potage	Hanswurst
Jig	Gigue
Joint-Stock-Company	Aktiengesellschaft
Kabbes	Weißkohl
Kabine	Kajüte
Kaff	Spreu
Kahnfüßer	Grabfüßer
Kalkuttahanf	Jute
Kombüse	Kombüse
Kammwalze	Igel
Kanapee	Sofa
Kandelgießer	Zinngießer
Kapillargefäßgeschwulst	Angiom
Kaprice	Capriccio
Kapudschi	Kammerherr
Kardätsche	Karde
Kargo	Schiffsmakler
Kartéll	Vertrag
Käsekohl	Blumenkohl
Käser	Senner
Kavatine	Arie
Kazike	Indianerhäuptling
Kehlschnitt	Tracheotomie
Keimling	Embryo
Kettenhemd	Kettenpanzer
Kimmung	Luftspiegelung
Kinäde	Päderast
Kinnbacken	Kiefer
Kirchendisziplin	Kirchenzucht
Kirchenrat	Kirchenvorstand
Kitschbaum	Traubenkirsche
Klausner	Einsiedler
Klerisei	Klerus
Knagge	Daumen
Kog	Polder
Kollektivglas	Sammellinse
Kommentar	Erklärung
Konjugation	Kopulation
Konkavspiegel	Hohlspiegel
Konkussion	Erpressung
Konsolidation	Arrondierung
Konstabel	Polizist
Kontumaz	Quarantäne
Konvént	Nationalkonvent
Koog	Polder
Kopula	Koppel
Korn	Feingehalt
Korporal	Unteroffizier
Korrespondénz	Postkarte
Kostbeere	Johannisbeere
Köter	Hund
Kotkäfer	Mistkäfer
Kraftverteilung	Kraftübertragung
Kraftwagen	Automobil
Kranich	Kran
Krankengymnastik	Heilgymnastik
Kratze	Karde
Kreide	Rötel
Krethi und Plethi	Gesindel
Kribbe	Buhne
Krinoline	Reifrock
Krümelzucker	Traubenzucker
Kuhkohl	Braunkohl
Kuhschelle	Küchenschelle
Kulloche	Kohlrübe
Kupferwasser	Eisenvitriol
Kurierzug	Schnellzug
Kurtisan	Hanswurst
Kutteln	Schlachthaus
Laboratorium	Alchimist
Lack	Goldlack
Lady	Frau
Lai	Lied
Laien	Weltpriester
Lakkiotikos	Acheron
Lambrequin	Helmdecke
Landboten	Landtagsabgeordnete
Landeshauptmann	Landesdirektor
Landschaft	Landstände
Lardit	Agalmatolith
Laufender Kurs	Tageskurs
Laufender Kurs	Kontokorrent
Laufhund	Bracke
Lavaglas	Obsidian
League	Liga
Leberblende	Schalenblende
Lebkuchen	Pfefferkuchen
Leichenöffnung	Obduktion
Leitsonde	Katheter
Leuchtende Farbe	Leuchtfarbe
Leudes	Hörige
Libation	Gelage
Libertin	Freigeist
Likorne	Einhorn
Lindwurm	Drache
Liwa	Brigadegeneral
Logenbruder	Freimaurer
Long Primer	Korpus
Lorbeerkirsche	Kirschlorbeer
Lore	Lori
Louis	Zuhälter
Luftdruckmaschine	Kompressor
Luftdruckpumpe	Kompressor
Luggerbank	Doggerbank
Lüster	Kronleuchter
Lydischer Stein	Lydit
Maat	Genosse
Mabeïn-Humajûn	Oberhofmarschall
Mac	Sohn
Mädchensommer	Altweibersommer
Maggiore	Dur
Magnoferrit	Roteisenerz
Maja	Schein
Makkaroni	Dummkopf
Mancipatio	Leibeigener
Mandelöl	Bittermandelöl
Mandrin	Katheter
Manendienst	Ahnenverehrung
Manua	Tau
Marabut	Derwisch
Mariengold	Glimmer
Markbrief	Kaperbrief
Massekurator	Konkursverwalter
Masseverwalter	Konkursverwalter
Massonei	Freimaurerei
Materie	Eiter
Matrosen	Gefreiter
Mauren	Araber
Mauvais sujet	Taugenichts
Mechanische Philosophie	Atomistik
Medîna	Stadt
Meisterlauge	Kalilauge
Mentor	Erzieher
Mesoblást	Mesoderm
Metagnostik	Metaphysik
Metretes	Amphora
Mezzanin	Halbgeschoß
Milchblattern	Kuhpocken
Militärpflicht	Wehrpflicht
Milo	Melos
Milos	Melos
Mimen	Schauspieler
Mimodrama	Pantomime
Minne	Liebe
Mister	Master
Mitraille	Maschinengewehr
Mlle	Mademoiselle
Mme	Madame
Mobilmiliz	Landwehr
Mogul	Großmogul
Mohr	Neger
Molybdänblei	Gelbbleierz
Monasterium	Münster
Moneta	Münzstätte
Monokratie	Monarchie
Monumént	Denkmal
Moral	Ethik
Mortifizieren	Amortisation
Most	Zider
Motion	Antrag
Mtama	Sorghum
Muchtar	Ortsvorsteher
Mückenfänger	Fliegenschnäpper
Mudir	Verwalter
Multum	Molton
Muskelblatt	Mesoderm
Myriomorphoskop	Kaleidoskop
Mystagog	Geheimniskrämer
Näherung	Approximation
Nahl	Narwal
Narde	Lavendel
Nationale	Kokarde
Natronglimmer	Paragonit
Navikular	Kahnbein
Negro	Neger
Neißer Schneeberg	Altvater
Neoplatonismus	Neuplatonismus
Nesseltuch	Musselin
Netto	Reinertrag
Névé	Firn
Nigritien	Neger
Nihilum album	Zinkoxyd
Nobiles	Adliger
Notiometer	Hygrometer
Novodo	Nauru
Nutznießung	Nießbrauch
O	Sohn
Oberkanonier	Obergefreiter
Obstzucker	Fruchtzucker
Offene Rechnung	Kontokorrent
Officium	Brevier
Ökonom	Nationalökonomie
Om	Amen
On dit	Gerücht
Ophiolith	Gabbro
Ostelbier	Agrarier
Ostensorium	Monstranz
Otter	Fischotter
Ovation	Huldigung
Owaihi	Hawaii
Oxytoluol	Kresol
P	Brief
Padovana	Pavane
Paduane	Pavane
Pahuins	Fan
Pakowolle	Alpakawolle
Paläologie	Paläontologie
Paläontographie	Paläontologie
Papier	Brief
Pappelstein	Malachit
Paralogie	Sophistik
Parastichon	Akrostichon
Parität	Simultanschule
Parksin	Zelluloid
Parlier	Polier
Partikulier	Privatier
Partite	Suite
Partout	Passepartout
Paschmina	Kaschmirwolle
Passe	Ausfall
Patelin	Schleicher
Pater peccavi	Schuldbekenntnis
Patres	Senat
Paulit	Hypersthen
Pegmatolith	Orthoklas
Peinliche Befragung	Strafgerichtsbarkeit
Peinliche Befragung	Strafprozeß
Peinliche Befragung	Strafrecht
Peljuinseln	Palauinseln
Pelz	Vlies
Pennal	Gymnasiast
Pentangulum	Pentagon
Pentangulum	Pentagramm
Peterlein	Petersilie
Pewter	Hartmetall
Pfandschilling	Pfandgeld
Pfarrkirche	Parochialkirche
Pfechten	eichen
Pfeifer	Spielleute
Pfleger	Vormund
Phantasie	delirieren
Pharo	Pharao
Pharus	Leuchtturm
Photographiedruck	Lichtdruck
Photohyalographie	Lichtdruck
Physikus	Arzt
Phytopergament	Pergamentpapier
Piano	Pianoforte
Pickelhering	Hanswurst
Pickling	Bückling
Pier	Mole
Pinakothek	Gemäldesammlung
Pisolith	Erbsenstein
Piva	Dudelsack
Plagium	Plagiat
Planisphärium	Astrolabium
Plaque	Furnier
Plasma	Protoplasma
Plástik	Bildhauerkunst
Plattdeutsch	Niederdeutsch
Plattlack	Schellack
Plebanus	Pfarrer
Plebs	Proletarier
Plockflöte	Blockflöte
Pneumatik	Aeromechanik
Podestà	Bürgermeister
Poësie	Dichtkunst
Pökling	Bückling
Polack	Pole
Politiker	Schlaukopf
Politische Ökonomie	Volkswirtschaftslehre
Politur	Politesse
Polize	Police
Polk	Regiment
Polychrom	Pyromorphit
Polymeter	Tachymeter
Pomesine	Apfelsine
Pönalkodex	Strafgesetzbuch
Porphyr	Melaphyr
Porsch	Porst
Porzellanton	Kaolin
Postgeheimnis	Briefgeheimnis
Potemkin	Blendwerk
Potpourri	Quodlibet
Pracher	Bettler
Prädikánt	Dominikaner
Präservation	Konservierung
Präzipitantia	Fällung
Priesterstand	Klerus
Privatgerichtsbarkeit	Patrimonialgerichtsbarkeit
Probe	Feingehalt
Procureur général	Generalprokurator
Promemoria	Memorial
Protagon	Lezithin
Prunkbock	Springbock
Psalter	Blättermagen
Psammit	Sandstein
Psychagogos	Totenbeschwörer
Psychomantie	Nekromantie
Punischer Apfel	Granatapfel
Puter	Truthuhn
Q	Quadrat
Quadersandsteinformation	Kreideformation
Quasi	Schein
Quaternär	Quartär
Quichua	Quechua
Quick	Quecksilber
Quincaillerie	Kurzwaren
Rack	Arrak
Rasenmeister	Abdecker
Rauhkalk	Rauchwacke
Rauhwacke	Rauchwacke
Reader	Lektor
Realobligation	Pfandbrief
Realservitut	Grunddienstbarkeit
Realwörterbuch	Enzyklopädie
Rear-admiral	Konteradmiral
Rebbes	Gewinn
Redoute	Maskenball
Referendar	Gerichtsassessor
Reflektieren	Spiegelteleskop
Regenwolke	Nimbus
Reinbau	Rohbau
Reißblei	Graphit
Religionswissenschaft	Theologie
Rengagement	Kapitulation
Rezdechaussee	Feuilleton
Rheometer	Galvanometer
Rhodiserholz	Rosenholz
Riedhuhn	Auerhuhn
Riesengranit	Pegmatit
Riet	Kamm
Ring	Kartell
Ringhemd	Kettenpanzer
Rodden	Aland
Rohrwerk	Zungenregister
Rollenzug	Flaschenzug
Rondel	Rondeau
Rose	Fensterrose
Roßkamm	Pferdehändler
Rotation	Fruchtfolge
Rothäute	Indianer
Rotkarpfen	Rotfeder
Rotkopf	Bluthänfling
Rotwild	Edelhirsch
Rübenreps	Rübsen
Rückenwirbel	Brustwirbel
Rückgrat	Wirbelsäule
Ruderfüßler	Ruderfüßer
Rufene	Bergsturz
Rüfi	Bergsturz
Ruppe	Aalraupe
Sabinerbaum	Sadebaum
Sagebaum	Sadebaum
Sägedach	Sheddach
Saikio	Kioto
Sakramentalen	Eideshelfer
Sakramentstag	Fronleichnamsfest
Säkularabt	Abbé
Salem	Jerusalem
Salfisch	Seeforelle
Samendrüsen	Hoden
Samenfluß	Pollution
Sammelspiegel	Hohlspiegel
Samstag	Sonnabend
San Bartolomeo de Honda	Honda
Sandblasapparat	Sandstrahlgebläse
Sandfisch	Sandaal
Sandgebläse	Sandstrahlgebläse
Sanitarium	Sanatorium
Santelholz	Sandelholz
Santen	Xanten
Santo Domingo	Haiti
Saugkiesel	Polierschiefer
Säule	Prisma
Schächer	Räuber
Schachmatt	Matt
Schäffler	Böttcher
Schäften	Kopulation
Schalenguß	Hartguß
Schalk	Knecht
Schallboden	Resonanzboden
Schanzkleid	Reling
Scheelium	Wolfram
Scheidung	Aufbereitung
Scheikh	Scheich
Schelam	Salem
Schema	Rangliste
Schichtwolke	Stratus
Schieferspat	Kalkspat
Schiertuch	Segeltuch
Schießwolle	Schießbaumwolle
Schillerquarz	Katzenauge
Schintoismus	Shintoismus
Schlägel	Fäustel
Schlagstock	Amboß
Schlängern	Schlingern
Schleiche	Blindschleiche
Schleimzucker	Fruchtzucker
Schleudermaschine	Zentrifuge
Schliefer	Klippschliefer
Schmelz	Email
Schmelzglas	Email
Schmerstein	Speckstein
Schmiedemaschine	Schmiedepresse
Schmiedesinter	Hammerschlag
Schmiere	Wache
Schnake	Ringelnatter
Schnecke	Volute
Schneeberg	Altvater
Schneerose	Alpenrose
Schout	Konteradmiral
Schränker	Einbrecher
Schreibblei	Graphit
Schrein	Tischler
Schrotbüchse	Kartätsche
Schuldbrief	Schuldschein
Schuner	Schoner
Schuster	Weberknecht
Schutzblattern	Kuhpocken
Schützen	Jäger
Schwarzer Porphyr	Melaphyr
Schweizer	Türhüter
Schwere	Gravitation
Schwererde	Schwerspat
Schwertleite	Ritterschlag
Schwimmwage	Aräometer
Seebataillon	Marineinfanterie
Seelenkult	Ahnenverehrung
Seerabe	Kormoran
Sekt	Champagner
Selbstzünder	Selbstentzündung
Separation	Absonderung
Seraphische Brüder	Franziskaner
Serechule	Mandingo
Sergeant	Feldwebel
Servelatwurst	Zervelatwurst
Sevenbaum	Sadebaum
Siberit	Rubellit
Sibirit	Rubellit
Sicherheitsleistung	Kaution
Siderit	Eisenspat
Silberstoff	Brokat
Silbertripel	Polierschiefer
Similigravüre	Autotypie
Sinngedicht	Epigramm
Sinteropal	Kieselsinter
Sismograph	Seismometer
Skarifikation	Grubber
Skio	Chios
Slagebrücke	Zugbrücke
Smarágd	Dioptas
Société anonyme	Aktiengesellschaft
Sodium	Natrium
Solomoninseln	Salomoninseln
Somersinseln	Bermudainseln
Sommerfäden	Altweibersommer
Sommerflug	Altweibersommer
Sonnenspiegel	Heliotrop
Sopka	Vulkan
Soter	Erlöser
Spagat	Bindfaden
Spagyrie	Alchimie
Spalthufer	Wiederkäuer
Spängler	Klempner
Spangrün	Grünspan
Spannkraft	Spannung
Speer	Lanze
Spelter	Zink
Spengler	Klempner
Sperberfalk	Hühnerhabicht
Sperrhaken	Dietrich
Sphärolithfels	Perlit
Spickdamm	Buhne
Spieß	Lanze
Spiritualismus	Spiritismus
Spitzsäule	Obelisk
Spodium	Knochenkohle
Sprachreinigung	Purismus
Springkäfer	Schnellkäfer
Sprinz	Sperber
Staatsverbrechen	Majestätsverbrechen
Staatsverrat	Landesverrat
Stadtgraf	Burggraf
Stahlstein	Eisenspat
Stake	Buhne
Stände	Landstände
Ständeversammlung	Landtag
Standia	Dia
Stange	Spieß
Stangenschörl	Turmalin
Starke	Färse
Stecher	Stichling
Steeplechase	Hindernisrennen
Stegreif	Steigbügel
Steinbeißer	Kernbeißer
Steinschmerle	Steinbeißer
Steintische	Dolmen
Steppenkuh	Säbelantilope
Stil	Zeitrechnung
Stiller Freitag	Karfreitag
Stoffmühle	Holländer
Stout	Porter
Strafmandat	Strafbefehl
Stralzio	Liquidation
Strandroggen	Strandhafer
Strang	Strähne
Strazze	Lumpen
Stückarbeit	Akkordarbeit
Stuhl	Thron
Stundenglas	Sanduhr
Sturmbrücke	Fallbrücke
Subjekt	Person
Sukzinit	Bernstein
Supplént	Hilfslehrer
Süßwasserkalk	Kalktuff
Svastika	Hakenkreuz
Swell	Stutzer
Syndikat	Kartell
Synode	Konzil
Szene	Landschaftsbild
Tabûr	Bataillon
Tachygraph	Stenographie
Talkerde	Magnesia
Talkspat	Magnesit
Tananarivo	Antananarivo
Tattersall	Reitbahn
Taubahn	Kabelbahn
Teerpappe	Dachpappe
Tempel	Gotteshaus
Teufelskralle	Rapunzel
Thebais	Oberägypten
Tier	Alttier
Tigerpferd	Zebra
Tikholz	Teakholz
Tintenstift	Kopierstift
Tironische	Stenographie
Torkel	Kelter
Transportation	Deportation
Trapporphyr	Melaphyr
Traube	Weintraube
Traubenbirne	Felsenbirne
Traubenvitriol	Eisenvitriol
Triebwerk	Transmission
Tripel	Kieselgur
Trippel	Kieselgur
Trommelreuse	Bunge
Trompete	Seenadel
Truppenlehre	Taktik
Trysegel	Gaffelsegel
Tschernagóra	Montenegriner
Tückebote	Irrlicht
Tuda	Toda
Tuffkalk	Kalktuff
Türkische Musik	Janitscharenmusik
Umschlag	Fehlgeburt
Universalelixier	Lebenselixier
Unschlitt	Talg
Untersuchungsprozeß	Inquisitionsprozeß
Urban	Hasel
Veloziped	Fahrrad
Veltenstanz	Epilepsie
Velveret	Manchester
Verbinder	Receiver
Verbum	Zeitwort
Verdauungsferment	Pepsin
Vergrößerungsglas	Lupe
Vergrößerungsspiegel	Hohlspiegel
Vergütungsbetrag	Konventionalstrafe
Verismus	Naturalismus
Verlassenschaft	Nachlaß
Versatzamt	Leihhaus
Verschleifung	Auflösung
Verschnittener	Kastrat
Vertragsstrafe	Konventionalstrafe
Verwaltung	Staatsverwaltung
Viadukt	Talbrücke
Vierseit	Viereck
Vinzentiner	Prämonstratenser
Viola	Bratsche
Visa	Visum
Visconte	Vicomte
Vizconde	Vicomte
Vollkugel	Vollgeschoß
Vollziehungsbeamter	Vollstreckungsbeamter
Vorgeschichte	Urgeschichte
Vorschuß	Darlehn
Votivtafel	Gedenktafel
Wachtelente	Krickente
Wagner	Stellmacher
Waldmensch	Orang-Utan
Walzenmühle	Walzenstuhl
Walzenpresse	Kalander
Weberblatt	Kamm
Wehrwolf	Werwolf
Weibersommer	Altweibersommer
Weißguß	Hartmetall
Weißmetall	Hartmetall
Welschkohl	Wirsing
Wenzel	Bube
Wetterkunde	Meteorologie
Wetterlosung	Wetterführung
Widewal	Pirol
Wigbold	Marktflecken
Wiluit	Vesuvian
Windmesser	Anemometer
Winzer	Weinbauer
Witiarchipel	Fidschiinseln
Wolkenkuckucksheim	Luftschloß
Wollblumen	Wundklee
Xereswein	Sherry
Yaúnde	Jaunde
Yuga	Weltalter
Zahlungsmandat	Zahlungsbefehl
Zalat	Rapfen
Zarzuela	Spieloper
Zaunriegel	Hartriegel
Zeichenschutz	Markenschutz
Zeitkauf	Kauf
Zenana	Frau
Zensur	Kirchenstrafe
Zensus	Volkszählung
Zeremonial	Zeremoniell
Zeug	Bierhefe
Zielkauf	Kauf
Zimentieren	eichen
Zinken	Stadtpfeifer
Zinsreduktion	Konversion
Zinsschein	Coupon
Zirkulationsorgane	Gefäßsystem
Zollbegleitschein	Begleitschein
Zugbock	Springbock
Zusammenlegung	Arrondierung
Zustandsvormundschaft	Kuratel
Zweikorn	Emmer
Zwetschengeist	Sliwowitz
Zwieback	Biskuit
Zwinglianer	Reformierte
Zwischengeschoß	Halbgeschoß
Zwischenhandel	Transithandel
Zwitter	Zinnerz
